BAKIN　サンプルゲーム	BAKIN Sample Game
\NPR[ルナ]\lipspd[0.6]いきなりナンなのよ！	\NPR[Luna]\lipspd[0.6]What is wrong with you!?
\NPL[エリザベータ]\lipspd[0.6]悪いけど、これも私の仕事なんでね！	\NPL[Elisabeta]\lipspd[0.6]Sorry, but it's my job!
\NPL[エリザベータ]\lipspd[0.6]行くよ！	\NPL[Elisabeta]\lipspd[0.6]Here we go!
\NPL[ベムス]ホッホッホッなかなかやりますね\!\nでは、本気を出しますかね。	\NPL[Bemus]Hohoho, that's pretty good.\!\nI think I'm going to get serious now.
\NPL[エリザベータ]\lipspd[0.6]なんだと!?	\NPL[Elisabeta]\lipspd[0.6]What the...?
\NPL[ベムス]ホッホッホッ、\wさぁ絶望なさい！	\NPL[Bemus]Hohoho, \wnow despair!
ケン…　\w[3]\n聞こえますか、ケン……	Ken... \w[3]\nCan you hear me, Ken ......
よかった…\n私の声が届いたようですね、\wケン……	Good...\nI guess my voice has been heard...\wKen ......
私の名はトライア…\nこの世の調和を護る精霊たちの女王	My name is Tria and I am the Queen of the Spirits, \nthe guardian of harmony in this world.
今、邪竜タマズサの手により\n私たちの力の源「精霊の宝珠」が危機にさらされています	Now, the source of our power, the Spirit Orbs, are in danger at the hands of the evil dragon Tamazusa!
宝珠の子ケンよ\n\n\n古からの宿命に従い\nあなたは旅立たねばなりません…	Ken... A child of the Spirit Orbs...\n\n\nIn accordance with the ancient fate, you must depart.
悪の手より精霊の宝珠を護るのです…\w[2]\n頼みましたよ…ケン…	You must protect the Spirit Orbs from the hands of evil...\w[2]\n\nI'm counting on you... Ken...
ケンの家	Ken's House
ちょっと！私の話聞いてる？\w[3]\n	Hey! Hey! Are you listening to me?\w[3]\n
\NPL[イザベラ]急にボーッとしちゃって…具合でも悪いの？	\NPL[Isabella]Why are you so spaced out all of a sudden, are you sick?
\NPL[イザベラ]え？　精霊女王と話をしていた？\nいつまで寝ぼけているのよ…\n\n準備ができたらすぐ来るように、サイラス先生が言ってたわよ。\n\n早く行きなさい！	\NPL[Isabella]What?  Have you been talking to the Spirit Queen?\nAre you still sleeping? ...\n\nMr. Cyrus said to come as soon as you're ready.\n\nGo now!
ネイテイ村	Neitei Village
\NPL[イザベラ]おつとめ頑張ってね。	\NPL[Isabella]Do your best for the service.
\NPL[イザベラ]村の外に出るときは気をつけるんだよ。	\NPL[Isabella]Be careful when you go out of the village.
これが精霊の剣か…\n不思議な力を感じる…\n\n…剣に手を伸ばした！	So this is the Spirit Sword... Sense of mysterious power...\n\n... Reaching for the sword!
精霊の剣を入手した！\nさっそく装備しよう！	You got the Spirit Sword! \nLet's equip it right away!
この滝の上に精霊の剣があるって言ってたな…	He said there's the Spirit Sword at the top of this waterfall...
ん？　なんの音だ……？	Hmm?　What's that noise......?
\NPL[???]精霊の剣を手にした者よ…\!\nその力を我に示して見せよ！	\NPL[???]Whoever holds the Spirit Sword in their hands...\!\nShow me your power!
ゴゴゴゴ	Rumble
\i滝壺から何かが近づいて来る！\w[5]\^	Something is approaching from the waterfall basin!\w[5]\^
\NPL[剣の番人]見事な戦いぶりであった。	\NPL[Sword Keeper]It was a splendid battle.
\NPL[剣の番人]行け…\nその剣でこの世の闇を払うのだ！	\NPL[Sword Keeper]Go... \nand use that sword to dispel the darkness of this world!
剣の番人に勝利した	Victory over the Sword Keeper
\NPL[剣の番人]まだまだ修業が足りぬようだな…	\NPL[Sword Keeper]It seems you still have a lot of training to do...
\NPL[剣の番人]しかし行け…\!\nこの剣と共にこの世の闇を払うのだ！	\NPL[Sword Keeper]But go... \!\nand with this sword, dispel the darkness of this world!
修行が足りぬようだな…\n精霊の剣を装備していないとか・・・	You're not trained enough... \nor you're not equipped with the Spirit Sword...
\NPL[エリザベータ]\lipspd[0.6]この洞窟のどこかにある精霊石を持ってなければ\n先には進めないよ！	\NPL[Elisabeta]\lipspd[0.6]We can't go on unless we have the spirit stone somewhere in this cave!
炎の精霊石を手に入れた！	We got the Spirit Stone of Fire!
炎の精霊石を見つけた!	We fousyubend the Spirit Stone of Fire!
しかし炎の精霊石をこれ以上持てなかったので、\n宝箱に戻した。	However, we couldn't have the Spirit Stone of Flame, so we put it back in the treasure chest.
しかしアイテム袋がいっぱいなので、\n炎の精霊石を宝箱に戻した。	But the inventory bag was full, so we put the Spirit Stone of Flame back in the treasure chest.
宝箱はすでに空っぽだ…	The treasure chest is already empty...
\i\>埋められた石版にはこう書いてある	\i\>The buried stone tablet says...
\i「イフリートの力が宿る精霊石を持つ者\n　汝を　精霊女王の使いと認める」	\i"Those of you who possess the spirit stone that holds the power of the Efreet, you are recognized as messengers of the Queen of Spirits."
\iここには何かありそうだ。周りをよく見てみよう。\n\n\n\iキーボードやコントローラーを使ってカメラを動かして洞窟の中をよく探してみましょう	\iThere might be something here. Let's take a closer look around.\n\n\iUse the keyboard or controller to move the camera and search the cave well.
石版のメッセージを読んだ。	He reads the message on the tablet.
\i石版にはこう書いてある。\!\n「イフリートの力が宿る精霊石をもつもの\n 汝を　精霊女王の使いと認める」	The buried stone tablet says...\n"Those of you who possess the spirit stone that holds the power of the Efreet, you are recognized as messengers of the Queen of Spirits."
\NPR[ルナ]\lipspd[0.6]あれ、動かない…	\NPR[Luna]\lipspd[0.6]Oh, it's not working...
\NPL[エリザベータ]\lipspd[0.6]動かすためのカギが足りないみたいだね。	\NPL[Elisabeta]\lipspd[0.6]Looks like we're missing a key to move it.
カギを探さないと	We have to find the key.
\NPR[ルナ]\lipspd[0.6]うわっ、動いたよ！	\NPR[Luna]\lipspd[0.6]Whoa, it's working!
\NPL[エリザベータ]\lipspd[0.6]ここはもういいから、先を急ごう！	\NPL[Elisabeta]\lipspd[0.6]We're done here. Let's move on!
古代のカギを手に入れた！	You got the Ancient Key!
ネムの滝は　西側のほうだったな。	Nem Falls is on the west side, I think.
サイラス先生のところにいかなきゃ！	I have to get to Mr. Cyrus!
おっと　サイラス先生に呼ばれてるんだった！	Oops, Mr. Cyrus wanted to see me!
さて・・・そろそろ教会に向かうか。\w[2]	Well... I guess I better be headed to the church.\w[2]
\i寄り道は後でしよう！	Let's stop by later!
ベムス「ケンさん　どちらへ行かれるのですかな？	Bemus: "Mr. Ken, where are you off to?"
精霊の宝珠を取りにいく	Getting the Spirit Orb
適当にごまかす	... Just taking a walk.
「おお、そうですか！　\n 持ってきたら　ぜひとも私にも見せてくださいね。	"Oh, I see!　\nWhen you get it, please be sure to show it to me."
「どちらに行かれるが存じ上げませんが\n　道中気をつけて…　\n　	"I don't know where you're going, but be careful on the way..." \n
看板を読む	Read the sign
\iこの奥危険\w[2]\^	\iDanger Ahead\w[2]\^
\iん？はじっこに何か書いてあるぞ	\iHmm? There's something written at the edge.
サイラス先生に剣を見せに行かないと！	I have to go show Mr. Cyrus my sword!
\i北：氷の洞窟（工事中につき通行不可）\n西：ネムの滝（足元注意！）	\iNorth: Ice Cave (Under Construction) \nWest: Nem Falls ( Watch your step! )
\iここはセーブポイントです。\n	\iThis is a save point. \n
\i「セーブの許可/禁止」イベントと組み合わせることで\nセーブポイントでだけセーブができるようなゲームを作ることもできます。	\iBy combining this with the "Enable/ Disable Save" event, you can create a game where the player can only save at save points.
\NPL[グレイ]やあ　ケン\!\nサイラスさんなら中でお待ちだよ。　\NPL[Gray]Hey, Ken!\nMr. Cyrus is waiting for you inside.　
\NPL[グレイ]村の外は危ないから気をつけてな。	\NPL[Gray]Be careful outside the village, it's dangerous.
\NPL[おじいさん]村のどこかに大事なことをメモしとったんじゃが\n何を書いたか忘れてしもうての…\n\nそれが気になって居てもたってもいられんのじゃ…	\NPL[Old Man]I scribbled down something important somewhere in the village, but I forgot what I wrote...\n\nThat's what's bothering me...
\>村の中を探しておじいさんのメモを見つけてあげよう！\<	\>Let's search the village and find the old man's memo for him!\<
\NPL[おじいさん]お、何かわかったかの？	\NPL[Old Man]Oh, did you find out?
はい	Yes
いいえ	No
\NPL[おじいさん]おぉ…は、はやく教えてくれい。	\NPL[Old Man]Oh...hurry up and tell me!
おじいさんのメモ	Old Man's Memo
\>バンダナをもらった。\<	\>He gave you a bandana.\<
\NPL[おじいさん]コレを頭にまいとけば\nお前の人気も爆上がりだぞい！	\NPL[Old Man]If you wear this on your head, \nyour popularity will skyrocket!
おじいさんの謎が解けた	You've solved the old man's problem.
\NPL[おじいさん]\$[おじいさんのメモ]\w[2]\nん……なんか違うのぅ…\n\nすまんが、また何かわかったら教えとくれ。	\NPL[Old Man]\$[Old man's memo]\w[2]\n...... Something's not right...\n\nThanks, but let me know if you find anything else.
\NPL[おじいさん]そうか…\n何だったかのぅ…	\NPL[Old Man]Well... I wonder what it was...
\NPL[おじいさん]BAKIN…\w[2]	\NPL[Old Man]BAKIN... \w[2]
\NPL[おじいさん]\z[150]それじゃーーーー！	\NPL[Old Man]\z[150]That's it!!!!
\NPL[おじいさん]いや、助かったわい。\!\nお礼にワシが若いころ使っとったコイツをあげよう。	\NPL[Old Man]Thank you for your help! \nI'll give you this that I used to use when I was young.
\NPL[おじいさん]おかげさんで頭がスッキリしていい気分じゃよ！	\NPL[Old Man]Thanks to you, my head is clearer and I feel better.
パワフルきのこを手に入れた！	You got a powerful mushroom!
\NPL[ベムス]ホッホッホッ、ケンさん…\!\n冒険に\w[1]\z[120]出ようとされてますよね！	\NPL[Bemus]Hohoho, Mr. Ken... \!\nYou're about to have an \w[1]\z[120]adventure!
そうなんです	That's right.
\NPL[ベムス]それならばもっとちゃんとした装備をしていかないと！\!\nこのベムスの店に寄っていきなさい！	\NPL[Bemus]Then you need to be more properly equipped!\nStop by this Bemus' shop!
\NPL[ベムス]ただの散歩とはいえ町の外で油断は禁物！\!\nいざという時のために、このベムスの店で装備を整えていきなさい！	\NPL[Bemus]Even if it's just a walk, you can't be too careful out of village! \!\nCome to Bemus' shop and get your gear ready for when the time comes!
\NPL[ベムス]くれぐれも気をつけて！\!\nホッホッホッ…	\NPL[Bemus]Careful out there! \!\nHohoho...
\NPL[ベムス]さぁ、早くいきなさい！\!時は金なり！	\NPL[Bemus]Now, go, go, go! \!Time is money!
\NPL[???]まだ早い。	\NPL[???]It's still early.
男は何を聞いてもしゃべってくれない…	The man won't talk no matter what you ask...
\NPR[ルナ]\lipspd[0.6]ねぇ、ケン！\!\nなんか面白そうなことしてるでしょ…！\n\n\lipspd[0.7]このルナさんも混ぜてよ！\!\nちょうどヒマしてるからさー。	\NPR[Luna]\lipspd[0.6]Hey, Ken! \!\nYou look like you're doing something exciting...!\n\n\lipspd[0.7]Count me in! \!\nI'm not busy at the moment.
わかったよ	Okay, sure
…ダメ。	...No
\NPR[ルナ]\lipspd[0.6]イイね~さすがケン！\!\n私、かなり使えるから！	\NPR[Luna]\lipspd[0.6]Great, that's Ken I know! \!\nI can be pretty useful!
ルナが仲間になった！	Luna has joined our party!
\NPR[ルナ]\lipspd[0.6]じ、冗談だよね…ケン。\!\n私の魔法、必要でしょ!?	\NPR[Luna]\lipspd[0.6]You're kidding, right, Ken!? \!\nYou need my magic!
どう断ってもついてくると言って聞かないようだ…\!\nあきらめよう…	No matter how hard you try to refuse her, she just won't stop saying she'll come with you... \!\nYou just need to give up...
\NPR[ルナ]\lipspd[0.6]やっぱ、わかってくれると思ってたー！\!\nじゃ、早速行こうよ！	\NPR[Luna]\lipspd[0.6]I knew you'd understand! \!\nThen let's get going!
くーん	*sniff*
ネムの滝は西側のほうだったな。	Nem Falls is on the west side, I think.
\NPL[???]\lipspd[0.6]お前がサイラスのいってたヤツか。	\NPL[???]\lipspd[0.6]So you're the one Cyrus was talking about.
\NPL[エリザベータ]\lipspd[0.6]悪いけどちょっと腕前を見せてもらうよ！\w[1]\^	\NPL[Elisabeta]\lipspd[0.6]Let's just see how good you are!\w[1]\^
\NPL[エリザベータ]\lipspd[0.6]なかなかやるね…	\NPL[Elisabeta]\lipspd[0.6]You're good.
\NPL[エリザベータ]\lipspd[0.6]私、エリザベータ。	\NPL[Elisabeta]\lipspd[0.6]I'm Elisabeta.
\NPL[エリザベータ]\lipspd[0.6]まだまだ見たいだけど、まぁいいだろう…	\NPL[Elisabeta]\lipspd[0.6]I'd like to see more, but that's okay...
\NPR[ルナ]\lipspd[0.6]付いてこなくていいのに…！	\NPR[Luna]\lipspd[0.6]You don't have to come with us...!
\NPL[エリザベータ]\lipspd[0.6]まーまー、よろしくね！	\NPL[Elisabeta]\lipspd[0.6]Hey, more the merrier, right?
\iエリザベータが仲間に加わった！	\iElisabeta has joined our party!
\NPR[ルナ]\lipspd[0.6]こんな大きな岩が入口をふさいでるなんて…\!\nどうしよう…	\NPR[Luna]\lipspd[0.6]I can't believe there's this huge rock blocking the entrance... \!\nWhat do we do?
\NPL[エリザベータ]\lipspd[0.6]ケン、さっきの精霊石を強く握って！	\NPL[Elisabeta]\lipspd[0.6]Ken, hold on tight to that spirit stone just we got!
\i握りしめた精霊石が光を放つ！	The spirit stone in your grip shines!
\NPR[ルナ]\lipspd[0.6]スゴイ！開いたよ！	\NPR[Luna]\lipspd[0.6]Awesome! It works!
\NPL[エリザベータ]\lipspd[0.6]さあ、中へ急ごう！	\NPL[Elisabeta]\lipspd[0.6]Come on, let's hurry inside!
\i大地の宝珠を手に入れた！\nサイラス先生に届けよう！	\iYou've got the Earth Orb! \nLet's get it to Mr. Cyrus!
\NPL[???]\z[150]ホッホッホッ…	\NPL[???]\z[150]Hohoho...
\NPL[???]よくぞ私をここまで導いてくれました。\!\nお礼を言いますよ、ケンさん。	\NPL[???]You have done well to lead me here. \!\nI thank you, Mr. Ken.
\NPL[ルナ]\lipspd[0.6]あ、あなたは…!!	\NPL[Luna]\lipspd[0.6]Oh, you're...!
\NPL[ベムス]表の顔はただの商店のオヤジ。\n\n\nですが、本当の私は竜王タマズサ様に…\!\nもっとも頼りとされている誇り高き眷属。	\NPL[Bemus]On the public face, I am just an old man in a store.\n\n\nBut the truth is that I am a proud family member who is most relied upon by the Dragon King Tamazusa.
\NPL[ベムス]あなたたちにもう用はありません！\!\n残念ですがここで死んでもらいますよ！	\NPL[Bemus]I have no more use for you people! \!\nI'm afraid you'll have to die here!
\NPL[ベムス]グフッ…\w[1]\n人間にしてはなかなかやりますね……\n\n次に会うときは、こうはいきませんよ！	\NPL[Bemus]Guffaw... \w[1]\nYou're pretty good for human......\n\nThe next time we meet, it won't be like this!
\NPL[ルナ]\lipspd[0.6]怪しいと思ってたけど…\!\nまさか竜の一族だったなんて…	\NPL[Luna]\lipspd[0.6]I thought he was suspicious...\!\nbut I never thought he was a member of the dragon family...
\NPL[エリザベータ]\lipspd[0.6]村に帰って、サイラスに会おう。\w[3]\^	\NPL[Elisabeta]\lipspd[0.6]Let's go back to the village and see Cyrus.\w[3]\^
\NPL[ベムス]ホッホッホッ…\!\n人間にしては　なかなかの実力のようですが\n\n私の敵ではなかったようですねぇ…	\NPL[Bemus]Hohoho...\!\nYou seem to be pretty good for human,\n\nbut I guess you're not my enemy...
ケンよ……再び立ち上がるのです！	Ken, ...... rise again!
\NPL[ベムス]あなたたちにもう用はありません！\!\n残念ですが、ここで死んでもらいますよ！	\NPL[Bemus]I have no more use for you people! \!\nI'm afraid you'll have to die here!
\iサイラス先生に報告しよう！	\iLet's report to Mr. Cyrus!
\NPR[ルナ]\lipspd[0.6]また行き止まりになってるよ…	\NPR[Luna]\lipspd[0.6]It's another dead end...
\NPL[エリザベータ]\lipspd[0.6]あの光っているところ、何か怪しいな…	\NPL[Elisabeta]\lipspd[0.6]There's something fishy about that glowing thing...
\NPR[ルナ]\lipspd[0.6]あ…あれ見て！	\NPR[Luna]\lipspd[0.6]Oh... look at that!
\NPL[エリザベータ]\lipspd[0.6]あれが大地の宝珠だよ…	\NPL[Elisabeta]\lipspd[0.6]That's the Earth Orb...
\iカチッと何かが外れる音がした	\iThere was the sound of something coming off.
\NPL[ベムス]さぁ、お安くしときますから！	\NPL[Bemus]Come on, I'll give you a discount!
\NPL[ベムス]ホッホッホッ、\w[1]これで旅も安心ですね！\n\n\n買ったものはちゃんと装備をしないと意味ないですからね。\w[1]\nホッホッホッ。	Hohoho \w[1]Now you're ready to travel!\n\n\nYou have to equip what you bought properly, otherwise they're useless.\w[1]\nHohoho
\NPL[ベムス]村の外は本当に危ないですよ！\!\nお母さんを悲しませないためにも…	\NPL[Bemus]It's really dangerous outside the village! \!\nDon't make your mother sad...
\NPL[ベムス]\z[150]買っていきなさい！	\NPL[Bemus]\z[150]Buy something here!
\NPL[ルナ]\lipspd[0.6]買うまで逃がしてくれなさそうだよ…	\NPL[Luna]\lipspd[0.6]I don't think he' gonna let us go until we buy...
\NPL[ベムス]ところで…\w[2]\n宝珠…\w[1]とやらを取りに行くって\n小耳にはさみましたけど…\!	\NPL[Bemus]By the way... I overheard that you're going to get \w[2]\nthe Orb\w[1]...\!
\NPL[ベムス]\z[150]本当なんですか？	\NPL[Bemus]\z[150]Is it true?
\NPR[ルナ]\lipspd[0]\c[000080]ケン…\wバカ正直なんだから…	\NPR[Luna]\lipspd[0]\c[000080]Ken...\wYou're being ridiculously honest...
\NPL[ベムス]ホッホッホッ…\w[3]\nそうなんですか…それは大変そうですな。	\NPL[Bemus]Hohoho...\w[3]\nWell... that sounds like a lot of work.
\NPL[ベムス]ホッホッホッ…\w[3]\n勘違いでしたか…	\NPL[Bemus]Hohoho...\w[3]\nI must be mistaken...
\NPL[ベムス]ま、無事にお帰りになられることを、このベムスも祈っておりますよ。\w[2]\n\z[150]ホッ\w[1]ホッ\w[1]ホッ…	\NPL[Bemus]Well, Bemus here wishes you a safe trip home. \w[2]\n\z[150]Ho\w[1]ho\w[1]ho...
\NPR[ルナ]\lipspd[0]\c[000080]なーんかやな感じ……	\NPR[Luna]\lipspd[0]\c[000080]What's with him? He's weird....
\NPL[ベムス]ホッホッホッ\w[2]さぁこれで準備万端\!\n行ってらっしゃい。\n	\NPL[Bemus]Hohoho, \w[2]You are all set. \!\nHave a good day.
これはなんだろう？	What's this?
ケン\nよく大地の宝珠を手に入れてくれた。\n\nお前は宝珠の剣士。\n全ての宝珠を護り、\nタマズサの野望を砕かねばならぬ宿命を背負っているのだ。\n\nまずは、あと7人いる宝珠の剣士たちを探せ。\nただ、そのうちの一人は\nおそらくすでに出会っているだろうがな。\n\n私は一時身を隠すが、お前たちが窮地に陥った時\n必ず戻ってくる。\n行け。ケン。	Ken\nYou did well to get the Earth Orb.\n\nYou are the Swordsman of the Orbs.\nYou have a destiny to protect all the Orbs \nand destroy Tamazusa's ambitions.\n\nThere are seven more swordsmen of the Orbs.\nYou must find them.\nAlthough, one of them has probably already met you.\n\nI'll go into hiding for a while, but I'll be back \nwhen you're in trouble.\nGo, Ken...
\NPL[エリザベータ]\lipspd[0.2]ケン…\wサイラスは……	\NPL[Elisabeta]\lipspd[0.2]Ken...\wCyrus probably left in searching for...
\NPR[ルナ]\lipspd[0.6]な、なに…？	\NPR[Luna]\lipspd[0.6]What the...?
\NPL[エリザベータ]\lipspd[0.6]早く外へ！	\NPL[Elisabeta]\lipspd[0.6]Come on, move out!
\NPR[ルナ]\lipspd[0.2]あれ、サイラスいないじゃん…	\NPR[Luna]\lipspd[0.2]Hey, Cyrus isn't here...
\c[FFFFFF]サンプルゲームはここまでです。\nマップエディターでゲームに登場した各マップを見ると\nこの先ゲームを広げていくヒントが見つかります。\nネイテイ村の洞窟の前にいる男をどかすイベントを組んでみたり、砂漠の別ルートへ進めるようにしてみたり。\n\nここまでのゲームのつくりを参考にしつつ\nこの先のケンの物語を創り進めてみてください。	\c[FFFFFF]This is the end of the sample game.\nIf you look at each map that has appeared in the game in the map editor, you will find hints on how to develop the game further.\nYou could try to set up an event to move the man in front of the cave in the village of Neitei out of the way, or allow the player to proceed to another route in the desert.\n\nWe hope that you will use the game's story so far \nas a guide in creating your own Ken story.
\NPL[サイラス]\lipspd[0.5]おぉ、やっと来たか！	\NPL[Cyrus]\lipspd[0.5]Oh, you're finally here!
\NPL[サイラス]\lipspd[0.5]ケン、村の西にあるネムの滝の祭壇から\n精霊の剣を取ってきてくれ。	\NPL[Cyrus]\lipspd[0.5]Ken, go get the Spirit Sword from the altar at the Nem Falls, west of the village.
\NPL[サイラス]\lipspd[0.5]あの剣が抜けるのか？って顔をしてるな…	\NPL[Cyrus]\lipspd[0.5]You look like you're saying, "That sword gonna be pulled out?" 
\NPL[サイラス]\lipspd[0.5]大丈夫…\!\n今日は抜けるはずだ。	\NPL[Cyrus]\lipspd[0.5]You'll be fine...\!\nYou can pull it out today.
\NPL[サイラス]\lipspd[0.5]ああ、途中魔物と会うかもしれないから\nこれも持っていきなさい。	\NPL[Cyrus]\lipspd[0.5]Oh, and take this with you in case you meet any monsters on the way.
ケンは薬草とポーション、復活の羽を手に入れた！	Ken got herbs and potions, and resurrection feathers!
\NPL[サイラス]\lipspd[0.5]じゃ、よろしくな。	\NPL[Cyrus]\lipspd[0.5]Well, good luck.
\NPL[サイラス]\lipspd[0.5]ネムの滝は\i村の西\iにある大きな滝だ。\!\nお前も子供のころ、よく魚釣りをして遊んだろう？	\NPL[Cyrus]\lipspd[0.5]Nem Falls is a large waterfall \iwest of the village\i. \!\nYou used to fish there when you were a kid, didn't you?
\NPL[サイラス]\lipspd[0.5]よくやった。	\NPL[Cyrus]\lipspd[0.5]Good job.
\NPL[サイラス]\lipspd[0.5]次は村の東、灼熱の洞窟を越えて\!\nその先にある「大地の宝珠」を取ってくるんだ。\n\n結構遠いから、気をつけていけよ！	\NPL[Cyrus]\lipspd[0.5]Next, go through the scorching cave east of the village and get the Earth Orb beyond it.\n\nIt's pretty far, so be careful out there!
\NPR[ルナ]\lipspd[0.5]急になんなの…？\!\n人使いが荒いんだから…	\NPR[Luna]\lipspd[0.5]Why does he ask for help all of a sudden...? \!\nHe works us too hard...
\NPL[サイラス]\lipspd[0.5]ルナは足手まといにならんようにな。	\NPL[Cyrus]\lipspd[0.5]Luna, try not to slow him down.
\NPR[ルナ]\lipspd[0.6]なるわけないでしょ!!	\NPR[Luna]\lipspd[0.6]It's not going to happen!
\NPL[サイラス]\lipspd[0.5]頼んだぞ…\w[1]ケン。\w[3]\^	\NPL[Cyrus]\lipspd[0.5]You can do it....\w[1]Ken\w[3]\n\^
\NPL[サイラス]\lipspd[0.5]大地の宝玉は東の洞窟の先にある。\!\nかなり危険な場所だぞ。	\NPL[Cyrus]\lipspd[0.5]The Earth Orb is located beyond the eastern cave. \!\nIt's a very dangerous place.
サイラス先生にベムスのことを伝えないと！	We have to tell Mr. Cyrus about Bemus!
\NPL[エリザベータ]\lipspd[0.6]早くサイラスのところへ行かないと！	\NPL[Elisabeta]\lipspd[0.6]We have to get to Cyrus as soon as possible!
グレイ\n「やあ　ケン。　サイラス先生に用事かい？\n　そういえば　さっきエリザベータがキミ探していたぜ。	Gray\n"Hello, Kens. You wanted to see Mr. Cyrus?\nBy the way, Elisabeta was looking for you earlier."
\i都合によりしばらく休業します ~ベムス商店~	\iWe're closed for a while for some reason ~Bemus Shop~
\iこの先砂漠地帯から灼熱の洞窟へ	\iBeyond this, from the desert to the scorching caves
\NPL[グレイ]やあ　ケン\!\nサイラスさんなら中でお待ちだよ。	\NPL[Gray]Hey, Ken\!\nMr. Cyrus is waiting for you inside.
ケン	Ken
ネイテイ村に住む青年。勇者だった父に憧れ、日々兼の修行に励んでいる。	A young man living in the village of Neitei. He admires his father, who was a brave warrior, and works hard every day to train himself as a warrior.
ルナ	Luna
ケンの幼馴染の魔法少女。ケンは妹だと思っているが、ルナは自分が姉だと思っている。	A magical girl who is Ken's childhood friend. Ken thinks of her as a younger sister, but Luna thinks she is an older sister.
エリザベータ	Elisabeta
謎の多い女剣士。サイラスの知り合いのようだが…。	A female swordsman with many mysteries. She seems to be an acquaintance of Cyrus, but...
サイラス	Cyrus
ケンをはじめネイテイ村の若者たちの教師役。気さくだが、少し謎めいた雰囲気を持つ。村のみんなには見せない過去の事情があるようだ。	He plays the role of a teacher for Ken and other young people in Neitei village.  He is friendly but a bit enigmatic.  There seems to be some circumstances in the past that he doesn't show to everyone in the village.
ベムス	Bemus
ネイテイ村唯一の商店を営む男。「ホッホッホッ」と笑うのがクセ。	A man who runs the only store in the village of Neitei. He has a habit of laughing and saying, "Hohoho".
スライム	Slime
ドロドロした粘液状態のモンスター。知性を持たない。	A monster in a sludgy, mucousy state. It has no intelligence.
スライムラヴァ	Slime Lava
高熱の溶岩地域に住む、ドロドロした粘液状態のモンスター。知性を持たない。	A monster in a sludgy, mucousy state. It has no intelligence.
オオコウモリ	Giant Bat
暗闇を好む吸血コウモリ。	A vampire bat that prefers the dark.
カニバルフラワー	Cannibal Flower
魔力の高い土地に咲く人食い花	A man-eating flower that blooms in a land with high magic power.
キラービー	Killer Bee
群れを成して襲い来る毒バチ。	Venomous bees attack in swarms.
コーラルスネーク	Coral Snake
溶岩地帯にすむ毒蛇。炎属性の魔法はあまり効かない。	A viper that lives in lava fields. It is resistant to fire magic.
キングコブラ	King Cobra
猛毒を持つ大型の蛇。\n	A large snake with a deadly poison.
サンドスネーク	Sand Snake
砂漠に住む毒蛇。	A viper that lives in the desert.
ゴブリン	Goblin
ゴブリンの中でも特に屈強な個体。	A particularly strong individual among goblins.
小柄な緑色の鬼。	A small green demon.
ダイアウルフ	Dire Wolf
硬く輝く毛皮を持つ狼。	A wolf with hard, shiny fur.
スケルトンファイター	Skeleton Fighter
骨の髄まで闘いが染みついてしまった戦士のむくろ。	The corpse of a warrior whose fight has seeped into the marrow of his bones.
サキュバス	Succubus
喜びの死を招く魔物。	A death-dealing demon of joy.
ウィザード	Wizard
魔術を操る意義までは理解できなかった者。	Those who did not understand even the significance of manipulating magic.
メイジ	Mage
闇に落ちた魔法学者のなれの果て。	The end of a magician who fell into darkness.
ゴーレム	Golem
土から生まれ、土にかえる心無き人造人間。	A mindless man-made human being born of the earth and returned to the earth.
メタルゴーレム	Metal Golem
魔力で動く金属の人形。	A metal doll powered by magic.
エンシェントドラゴン	Ancient Dragon
神の力を持つと言われる龍の一族。	A family of dragons said to possess divine powers.
ホワイトウルフ	White Wolf
雪原に生息する狼。	A wolf that lives in the snowfield.
魔法使い	Wizard
闇の力に魅せられてしまった魔法使い。	A wizard who has become fascinated with the power of darkness.
エレメント	Element
この世に未練を残した死者の魂。	The souls of the dead who have left their regrets in this world.
ウィルオーウィスプ	Will-O-Wisp
醜い情念の炎をまとった死者の魂。	The souls of the dead clad in the flames of ugly passions.
盗賊	Thief
旅人を狙って金品を奪う荒くれ者。	A roughneck who targets travelers and robs them of their money.
大魔道士	Grand Mage
闇の力を操る魔法使い。	A mage who controls the power of darkness.
3Dモンスター	3D Monsters
アイアンゴーレム	Iron Golem
アイアンシザーズ	Iron Scissors
アイススライム	Ice Slime
ストーンゴーレム	Stone Golem
レッドゴーレム	Red Golem
エビルスピリッツ	Evil Spirit
ウィザード	Wizard
ドブネズミ	Giant Rat
ゴブリンキング	Goblin King
ゾンビ	Zombie
闇の力で動く死体。	A corpse moved by the power of darkness.
ナイフ	Knife
父から誕生日にもらった、小ぶりのナイフ。	A small knife that his father gave him for his birthday.
サバットナイフ	Sabbat Knife
精霊の剣	The Spirit Sword
勇者の資質がないと、手に持つことすらできない精霊の剣。	Without the qualities of a hero, it is impossible to even hold the sword of the spirit in their hands.
#武器	#Weapons
薬草	Medical Herb
HPを回復する薬草。ちょっと苦い。	A medicinal herb that restores HP. A little bitter.
ポーション	Potion
HPをかなり回復する飲み薬。少し甘い。	A drink that restores a lot of HP. A little sweet.
マジックハーブ	Magical Herb
MPを回復する薬草。かなり苦い。	A medicinal herb that restores MP. Very bitter.
マジックポーション	Magical Potion
MPをかなり回復する飲み薬。結構甘い。	A drink that restores a lot of MP. It is quite sweet.
フルポーション	Full Portion
HPとMPだけでなく、怪我も完全回復する秘薬。	A potion that completely heals not only HP and MP, but also injuries.
毒消しハーブ	Antidote Herb
毒を治す薬草。微妙な味。	A medicinal herb that cures poison. Tastes not so good.
ディスペルハーブ	Dispel Herb
状態異常を治す薬草。ピリ辛。	A herb that cures abnormal states. Spicy.
パワフルきのこ	Powerful Mushroom
すべての能力の最大値をアップさせる不思議なきのこ。	A mysterious mushroom that increases the maximum value of all abilities.
精霊の宝珠	Spirit Orb
精霊女王の力が宿る宝珠。世界に８つあるらしい。	Orbs that contain the power of the Queen of Spirits. There are apparently eight of them in the world.
復活の羽	Resurrection Feather
戦闘不能を治す不死鳥の羽	A phoenix feather that cures KO state
炎の呪文書	Flame Spellbook
ファイアの魔法が発動する書物	A book that activates the magic of Fire
幻影の呪文書	Illusion Spellbook
ブリンクボディの魔法が発動する書物	A book that activates the magic of the blink body
青銅のカギ	Bronze Key
銅で作られた粗末なカギ	A poorly made key made of copper.
白銀のカギ	Silver Key
銀で作られた立派なカギ	A fine key made of silver.
黄金のカギ	Golden Key
金で作られた豪華なカギ	A gorgeous key made of gold.
古代のカギ	Ancient Key
ぼろぼろに朽ちたカギ	A tattered and decayed key.
カードキー	Card Key
謎の金属で作られた板	A plate made of a mysterious metal.
村長の手紙	Mayor's Letter
村長の話を聞くともらえる手紙	A letter given after listening to the mayor
冒険者の証	Adventurer's Certificate
冒険者として認められた証	A certificate of recognition as an adventurer
村人の依頼書1	Villager's Request 1
村人からの依頼内容が書かれた紙	A piece of paper with a request from a villager
村人の依頼書2	Villager's Request 2
村人の依頼書3	Villager's Request 3
月光草	Moonflower
あらゆる病気を治す幻の花	A legendary flower that cures all diseases
古文書	Ancient Document
古代魔法語で書かれた謎の書物	A mysterious book written in an ancient magical language
ギルドの依頼書1	Guild Request 1
ギルドからの依頼内容が書かれた紙	A piece of paper with a request from the guild
ギルドの依頼書2	Guild Request 2
ギルドの依頼書3	Guild Request 3
賢者の石板	Tablet of the Sage
偉大なる賢者が残した予言の石板	A stone tablet of prophecy left by a great sage
王の許可証	King's Permit
王様から与えられた許可証	A permit given by the king
鷲獅子の紋章	Emblem of the Eagle and Lion
グリフォンを象った古代王国のシンボル	Ancient Kingdom Symbol in the Shape of a Gryphonc
炎の精霊石	Spirit Stone of Flame
イフリートの力が宿る精霊石。	A spirit stone in which the power of the Efreet resides
水の精霊石	Spirit Stone of Water
ウンディーネの力が宿る精霊石。	A spirit stone in which the power of Undine resides
風の精霊石	Spirit Stone of Wind
シルフィードの力が宿る精霊石。	A spirit stone where the power of Sylphid resides
土の精霊石	Spirit Stone of Earth
ノームの力が宿る精霊石。	A spirit stone where the power of gnomes resides
魔獣の角	Horn of Beast
魔獣を倒した証	Proof of defeating a beast
バンダナ	Bandana
#防具	#Armor
布製のハチマキ	A cloth headgear
レザーハット	Leather Hat
動物の皮でつくられた帽子	A hat made of animal skin
チェインヘルム	Chain Helm
鉄の鎖で編まれた兜	A helmet woven with iron chains
クレストヘルム	Crest Helm
紋章の刻まれた騎士の兜	A knight's helmet with an engraved emblem
レザーチュニック	Leather Tunic
動物の皮でつくられた厚手の服	Thick clothing made from animal skins
チェインメイル	Chain Mail
鉄の鎖で編まれた鎧	Armor woven with iron chains
メイジローブ	Mage Robe
MPを増幅する魔法使いのローブ	Wizard's robe to boost MP
クレストメイル	Crest Mail
紋章の刻まれた騎士の鎧	Armor of a knight with an engraved emblem
ルーンクロス	Loon Cloth
MPを増幅する魔法使いのローブ	Wizard's robe to boost MP
レザーグローブ	Leather Gloves
動物の皮でつくられた手袋	Gloves made from animal skins
バックラー	Buckler
攻撃を受け流す小型の盾	A small shield that deflects attacks
スパイクシールド	Spike Shield
表面にトゲのついた円盾	A circular shield with a spiked surface
クレストシールド	Crest Shield
紋章の刻まれた騎士の盾	A knight's shield with an engraved emblem.
盗賊のブーツ	Thieves' Boots
素早さと回避率が上がる魔法のブーツ	Magic boots that increase speed and evasion rate
虹色の魔除け	Rainbow-Colored Amulet
あらゆる状態異常に強くなる魔除け	An amulet that makes them resistant to all kinds of abnormal states
精霊の腕輪	Spirit Bracelet 
全属性のダメージを半分にする腕輪	A bracelet that halves the damage of all attributes
ブラスナックル	Brass Knuckles
拳にはめる格闘武器	A fighting weapon that fits in the fist.
アイアンハンマー	Iron Hammer
鋼鉄で作られた重いハンマー	Heavy hammer made of steel
バトルアクス	Battle Axe
戦士が好んで使う両刃の斧	A double-edged axe favored by warriors
セージロッド	Sage Rod
聖属性を秘めた魔法使いの杖	A wizard's staff with hidden holy attribute
ポイズンダガー	Poison Dagger
斬りつけた相手を毒にする猛毒のダガー	A highly poisonous dagger that poisons the opponent it slashes
アイスソード	Ice Sword
氷属性を秘めたロングソード	A longsword with hidden ice attribute
フレイムナックル	Flame Knuckle
火属性を秘めたナックル	Knuckles with fire attribute
サンダーアクス	Thunder Axe
雷属性を秘めたバトルアクス	A battleaxe with hidden lightning attribute
ヒーリング	Healing
味方ひとりのHPを回復する	Restores the HP of an ally
エリアヒール	Area Heal
味方全員のHPを回復する	Restores the HP of all allies
キュアポイズン	Cure Poison
味方ひとりの毒を治す	Cures poison in an ally
レイズ	Raise
味方ひとりを戦闘不能から復活させる	Resurrects an ally from KO state
パワーブースト	Power Boost
味方ひとりの攻撃力をアップする	Increases the attack power of one ally
ブリンクボディ	Blink Body
味方ひとりの回避率をアップする	Increases the evasion rate of one ally
ファイア	Fire
敵一体に火属性のダメージを与える	Deals fire damage to one enemy
アイス	Ice
敵一体に氷属性のダメージを与える	Deals ice damage to one enemy
サンダー	Thunder
敵一体に雷属性のダメージを与える	Deals thunder damage to one enemy
ファイアⅡ	Fire II
敵全体に火属性のダメージを与える	Deals fire damage to all enemies
アイスⅡ	Ice II
敵全体に氷属性のダメージを与える	Deals ice damage to all enemies
サンダーⅡ	Thunder II
敵全体に雷属性のダメージを与える	Deals thunder damage to all enemies
毒牙	Poison Fang
吸血	Bloodsucking
相手のHPを吸収して自分のHPを回復する	Absorb opponent's HP and recover own HP
麻痺にらみ	Paralytic Glare
相手を麻痺させる	Paralyze the opponent
ファイアブレス	Fire Breath
敵全体に火属性のダメージを与える	Deals fire damage to all enemies
アイスブレス	Ice Breath
敵全体に氷属性のダメージを与える	Deals ice damage to all enemies
サンダーブレス	Thunder Breath
敵全体に氷属性のダメージを与える	Deals lightning damage to all enemies
アシッドブレス	Acid Breath
敵全体にダメージを与えて防御力もダウンさせる	Deals damage to all enemies and reduces their defense
アサシンブレード	Assassin Blade
相手を即死させる（命中率は低い）	Kills the opponent instantly (low accuracy)
呪い	Curse
敵全体のすべての属性耐性を下げる	Reduces all attribute resistance of all enemies
グランドシェイク	Grand Shake
ファイヤーエクスプロージョン	Fire Explosion
セクシーアイ	Sexy Eye
剣士	Swordsman
神官	Priest
ビーストテイマー	Beast Tamer
無	Non-element
火	Fire
氷	Ice
風	Wind
雷	Lightning
聖	Holy
冥	Dark
毒	Poison
眠り	Sleep
麻痺	Paralysis
即死	Instant Death
混乱	Confusion
魅了	Charm
リザルト	Results
聖堂	Church
G	G
泊まる	Stay
泊まらない	Not Staying
お金が足りない...	Not enough money...
買う	Buy
売る	Sell
やめる	Quit
{0}を購入しました	Bought {0}
{0}を売却しました	Sold {0}
種類	Types
属性	Attribute
セーブしました！	Saved!
上書き保存します。よろしいですか？	Overwrite save file?
決定	OK
カーソル移動	Cursor Movement
キャラクター選択	Select Cast
設定変更	Change Settings
閉じる	Close
命中率	Accuracy
消費{0} : {1}	Cost {0} : {1}
アイテム無し	No Items
消費アイテム	Consumables
武器	Weapon
攻撃力	Attack Power
鎧	Body Armor
防御力	Defense
盾	Shield
回避率	Evasion
兜	Headgear
アクセサリー	Accessory
所持数	Owned
セーブデータ	Save Data 
アイテム袋がいっぱいです。	Your inventory is full.
どのアイテムを捨てますか？	Which item(s) do you want to discard?
{0}をすべて捨てます。よろしいですか？	Discard all {0} items. Are you sure?
{0}をあきらめる	Discard {0}
アイテムが一杯のため、装備が外せませんでした。	The equipment cannot be removed\nbecause this would exceed the maximum item limit.
本当にゲームを終了しますか？	Are you sure you want to exit the game?
先制攻撃だ！	We preempted!
先制攻撃された！	We've been preempted!
アイテム	Items
スキル	Skills
装備	Equipment
ステータス	Status
セーブ	Save
ゲーム終了	Exit Game
使う	Use
捨てる	Discard
LV	LV
HP	HP
MP	MP
状態	State
正常	Normal
戦闘不能	KO
誰が使いますか？	Who would use it?
スキル無し	No Skills
誰の装備を変更しますか？	Whose equipment do you want to change?
はずす	Remove
なし	Nothing
誰のステータスを見ますか？	Whose status do you want to see?
腕力	Brute Strength
体力	Physical Strength
魔力	Magic Power
素早さ	Agility
経験値	Exp
つぎのレベルまで	To the Next Level
ゲームオーバー	Game Over
誰を攻撃しますか？	Who do you want to attack?
誰に使用しますか？	Who do you use it on?
{0}は様子を見ている	{0} is surveying the situation...
{0}は眠っている……	{0} is sleeping...
{0}は麻痺で動けない！	{0} is paralyzed and can't move!
{0}の会心の一撃！	{0}'s critical blow!
{0}は身を守っている……	{0} is defending...
{0}は力をためている……	{0} is charging up power...
{0}の攻撃！	{0}'s attack!
{1}	{1}
モンスターが現れた！	The monsters are emerging!
戦闘に勝利した！	You have won the battle!
全滅した……	Annihilated......
逃げ出した……	Ran away......
お金を{0}{1}手に入れた！	You got {0} {1} money!
アイテム[{0}]を手に入れた！	You got item [{0}]!
経験値を{0}ポイント獲得した！	You got {0} experience points!
レベルアップ！	Level Up!
逃げる	Escape
ミス	Miss!!
戻る	Back
はい	Yes
いいえ	No
一瞬	Instant
速い	Fast
普通	Normal
遅い	Slow
記憶する	Memorize
記憶しない	Not Memorize
BGM	BGM
効果音	Sound Effects
メッセージ速度	Message Speed
カーソル位置	Cursor Position
初期設定に戻す	Restore Defaults
はじめから	New Game
続きから	Continue
コンフィグ	Config
属性攻撃力	ATTR ATK
所持金	Money in Possession
プレイ時間	Play Time
続き	Continue
{0}は毒を受けている！	{0} is poisoned...
{0}は混乱している！	{0} is confused...
{0}は魅了されている！	{0} is charmed...
{0}は逃げ出した！	{0} escaped!
{0}は混乱から回復した！	{0} recovered from confusion!
{0}は立ち上がった！	{0} stood up!
{0}は魅了から回復した！	{0} recovered from charm!
{0}は麻痺から回復した！	{0} recovered paralysis!
{0}は毒から回復した！	{0} recovered from poison!
{0}は目を覚ました！	{0} has woken up!
逃げることができなかった！	Could not escape!
Exp	Exp
通常攻撃	Normal Attack
攻撃	Attack
防御	Guard
スキル	Skill
アイテム	Item
パーティー	Party
コマンド	Commands
会話	Conversation
メッセージ表示上	Message (Top)
メッセージ表示中央	Message (Middle)
メッセージ表示下	Message (Bottom)
メッセージ表示用	For Displaying Message
ネームプレート上	Name Plate (Top)
ネームプレート左	Name Plate (Left)
ネームプレート中央	Name Plate (Middle)
ネームプレート右	Name Plate (Right)
ネームプレート下	Name Plate (Bottom)
表示キャスト1	Displaying Cast 1
表示キャスト2	Displaying Cast 2
テロップ	Ticker
背景画像	Background Image
テロップメッセージ	Ticker Message
テロップスクロールメッセージ	Ticker Scroll Message
ショップ選択	Selection
ショップ選択肢	Selection
所持金表示	Money in Possession
ショップ買う	Buy
販売アイテム表示	Sales Items
値段	Price
選択アイテム詳細	Selected Item Details
種別	Category
装備ステータス	Equipment Status
ショップ購入個数	Quantity Purchased
ショップ個数選択	Quantity Selection
アイテム名	Item Name
値段	Price
ショップ売る	Sell
売却アイテム表示	Sold Items
選択アイテム詳細	Selected Item Details
選択アイテム説明文	Selected Item Description
種別	Category
装備ステータス	Equipment Status
ショップ売却個数	Quantity Sold
ショップ個数選択	Quantity Selection
アイテム名	Item Name
値段	Price
宿屋選択左上	Top-Left
宿屋選択上	Top
宿屋選択右上	Top-Right
宿屋選択左	Left
宿屋選択中央	Center
宿屋選択右	Right
宿屋選択左下	Bottom-Left
宿屋選択下	Bottom
宿屋選択右下	Bottom-Right
所持金表示	Money in Possession
レベルアップ	Level Up
バトルスキル選択	Battle Skill Selection
取得スキル詳細表示	Acquired Skill Details
選択スキル詳細表示	Selected Skill Details
交代	Replace
図鑑	Picture Book
マップ	Map
終了	Exit
使用する対象を選んでください	Select the target to be used
次のレベルまで	Until Next Level
スキル : \currentdictionaryskillsname[3]	Skill: \currentdictionaryskillsname[3]
アイテム : \currentdictionaryitemsname[3]	Item: \currentdictionaryitemsname[3]
HP : \currentdictionarystatus[1]	HP: \currentdictionarystatus[1]
守備力 : \currentdictionarystatus[6]	Defense Power: \currentdictionarystatus[6]
攻撃力 : \currentdictionarystatus[5]	Attack Power: \currentdictionarystatus[5]
魔力 : \currentdictionarystatus[7]	Magical Power: \currentdictionarystatus[7]
素早さ : \currentdictionarystatus[8]	Agility: \currentdictionarystatus[8]
上書き保存します。よろしいですか?	Overwrite and save. Are you sure?
BGM	BGM
効果音	Sound Effects
一瞬\n速い\n普通\n遅い	Instantly\nFast\nNormal\nSlow
記憶する\n記憶しない	Memorize\nNot Memorize
本当にゲームを終了しますか	Quit the game?
お金	Money
バトルメッセージ	Battle Message
メッセージ	Message
スキル詳細表示	Skill Details Window
使用者名前	User Name
名前下線	Name Underline
アイコン画像	Icon Image
スキル名前	Skill Name
消費HP	HP Consumption
消費MP	MP Consumption
説明	Description
使用スキル表示	Skills Used Window
名前	Name
スキル1	Skill 1
スキル2	Skill 2
スキル3	Skill 3
スキル4	Skill 4
スキル5	Skill 5
アイテム詳細表示	Item Details Window
アイコン画像	Icon Image
個数	Quantity
使用アイテム表示	Items Used Window
アイテム1	Item 1
アイテム2	Item 2
アイテム3	Item 3
アイテム4	Item 4
アイテム5	Item 5
アイテム6	Item 6
交代メニュー表示	Replacing Menu Window
メンバー1	Member 1
メンバー2	Member 2
メンバー3	Member 3
メンバー4	Member 4
メンバー5	Member 5
メンバー6	Member 6
メンバー7	Member 7
コマンドメニュー表示	Command Menu Window
コマンド1	Command 1
コマンド2	Command 2
コマンド3	Command 3
コマンド4	Command 4
コマンド5	Command 5
コマンド6	Command 6
リザルト表示	Results Window
お金ラベル	Money Label
お金	Money
経験値ラベル	EXP Label
経験値	EXP
タイトル	Title
獲得アイテム	Acquired Items
獲得アイテム表示	Acquired Items Window
Loadingテキスト	Loading Text
背景	Background
タイトル名とサブタイトル名	Title and Subtitle Names
タイトル名	Title Name
サブタイトル名	Subtitle Name
初めから、続きから、コンフィグ	New Game, Continue, Config
はじめからテキスト	New Game Text
続きからテキスト	Continue Text
コンフィグテキスト	Config Text
メインメニュー表示	Main Menu Window
装備	Equipment
メンバー	Members
マップ	Maps
セーブ	Save
ゲーム終了	Exit Game
終了	Exit
使用先選択表示	Destination Selection Window
使用先選択	Destination Selection
キャスト1	Cast 1
キャスト2	Cast 2
キャスト3	Cast 3
キャスト4	Cast 4
顔アイコン	Face Icon
レベル	Level
HP	HP
HP値	HP Value
MP	MP
MP値	MP Value
状態異常テキスト	Abnormal State Text
状態異常アイコン	Abnormal State Icon
スキル使用者表示	Skill Users Window
使用者スキル一覧表示	User Skill List Window
スキル1アイコン画像	Skill 1 Icon Image
スキル1名前	Skill 1 Name
スキル2アイコン画像	Skill 2 Icon Image
スキル2名前	Skill 2 Name
スキル3アイコン画像	Skill 3 Icon Image
スキル3名前	Skill 3 Name
スキル4アイコン画像	Skill 4 Icon Image
スキル4名前	Skill 4 Name
スキル5アイコン画像	Skill 5 Icon Image
スキル5名前	Skill 5 Name
スキル6アイコン画像	Skill 6 Icon Image
スキル6名前	Skill 6 Name
スキル7アイコン画像	Skill 7 Icon Image
スキル7名前	Skill 7 Name
選択キャスト画像表示	Selected Cast Image Window
選択キャスト画像	Selected Cast Image
名前下線	Name Underline
使用先選択表示	Destination Selection Window
装備変更者表示	Equipment Changer Window
選択キャスト装備プレビュー	Selected Cast Equipment Preview
選択キャスト名前	Selected Cast Name
装備キャスト名前	Equipped Cast Name
選択キャスト装備プレビュー	Selected Cast Equipment Preview
選択キャスト名前	Selected Cast Name
剣アイコン	Sword Icon
装備剣アイコン画像	Equipped Sword Icon Image
装備剣名前	Equipped Sword Name
盾アイコン	Shield Icon
装備盾アイコン画像	Equipped Shield Icon Image
装備盾名前	Equipped Shield Name
兜アイコン	Headgear Icon
装備兜アイコン画像	Equipped Headgear Icon Image
装備兜名前	Equipped Headgear Name
鎧アイコン	Armor Icon
装備鎧アイコン画像	Equipped Armor Icon Image
装備鎧名前	Equipped Armor Name
アクセサリー1アイコン	Accessory 1 Icon
装備アクセサリー1アイコン画像	Equipped Accessory 1 Icon Image
装備アクセサリー1名前	Equipped Accessory 1 Name
アクセサリー2アイコン	Accessory 2 Icon
装備アクセサリー2アイコン画像	Equipped Accessory 2 Icon Image
装備アクセサリー2名前	Equipped Accessory 2 Name
変更部位表示	Changing Parts Window
装備種類アイコン	Equipment Type Icon
剣	Sword
盾	Shield
兜	Headgear
鎧	Armor
アクセサリー1	Accessory 1
アクセサリー2	Accessory 2
ステータス表示	Status Window
装備キャスト名前	Equipped Cast Name
レベル値	Level Value
攻撃力	Attack Power
攻撃力値	Attack Power Value
属性攻撃力	Attribute Attack
属性攻撃力値	Attribute Attack Value
防御力	Defense Power
防御力値	Defense Power Value
魔力	Magical Power
魔力値	Magical Power Value
素早さ	Agility
素早さ値	Agility Value
命中率	Accuracy
命中率値	Accuracy Value
回避率	Evasion Rate
回避率値	Evasion Rate Value
経験値値	EXP Value
次のレベルまで	Until Next Level
次のレベルまで値	Until Next Level Value
装備選択表示	Equipment Selection Window
装備説明	Equipment Description
装備1	Equipment 1
装備2	Equipment 2
装備3	Equipment 3
装備4	Equipment 4
装備5	Equipment 5
パーティ表示	Party Window
控え表示	Reserve Window
図鑑一覧表示	Picture Book List Window
図鑑1	Picture Book 1
図鑑2	Picture Book 2
図鑑3	Picture Book 3
図鑑4	Picture Book 4
図鑑5	Picture Book 5
図鑑詳細表示	Picture Book Details Window
說明	Description
守備力	Defense Power
画像	Image
マップ表示	Map Window
セーブデータ表示	Save Data Window
セーブデータ1	Save Data 1
セーブデータ2	Save Data 2
セーブデータ3	Save Data 3
セーブデータ4	Save Data 4
セーブデータ5	Save Data 5
マップ名	Map Name
日付	Date
時間	Time
パーティー先頭顔アイコン	Party Leader Face Icon
パーティー先頭名前	Party Leader Name
パーティー先頭レベル	Party Leader Level
セーブ時のパーティ表示	Party at Save Time Window
状態アイコン	Condition Icon
セーブ上書き確認表示	Save Overwrite Confirmation Window
上書き確認	Overwrite Confirmation
はい	Yes
いいえ	No
設定表示	Settings Window
BGM	BGM
スライダー	Slider
BGM下線	BGM Underline
効果音	Sound Effects
効果音下線	Sound Effects Underline
メッセージ速度	Message Speed
左右カーソル	Left/Right Cursor
メッセージ速度下線	Message Speed Underline
カーソル位置	Cursor Position
カーソル位置下線	Cursor Position Underline
初期設定に戻す	Restore Defaults
初期設定にもどす	Restore Defaults
終了確認表示	Exit Confirmation Window
終了確認	Exit Confirmation
マップ名表示帯	Map Name Window
Gameover	Game Over
ロゴ	Logo
敵ステータス表示	Enemy Status Window
トレーナー	Trainer
敵1	Enemy 1
敵2	Enemy 2
敵3	Enemy 3
敵4	Enemy 4
敵5	Enemy 5
敵6	Enemy 6
HPラベル	HP Label
MPラベル	MP Label
見出し	Headline
セレクタ	Selector
所持数 : \currentitemnum	Owned: \currentitemnum
消費HP : \currentskillconsumptionhp	HP: \currentskillconsumptionhp
消費MP : \currentskillconsumptionmp	MP: \currentskillconsumptionmp
標準	Normal
所持アイテム表示	Items Possessed Window
説明文表示	Description Window
説明文テキスト	Description Text
アイテム袋がいっぱいです。どのアイテムを捨てますか?	Your inventory is full. Which item(s) would you like to discard?
\currentitemname を全て捨てます。よろしいですか。	Discard all \currentitemname. Are you sure?
アイテム破棄確認表示	Item Discard Confirmation Window
破棄確認	Discard Confirmation
サイラスの話を聞いた	Heard story from Cyrus
家から出た	Out of House
イザベラから話を聞いた	Heard story from Isabella
家から出ようとした	Tried to out from House
精霊の使徒登場	Appearance of the Spirit Apostle
スキル_反射の極意	Skill_art of reflection
精霊の剣を入手した	Got Spirit Sword
エリザベータ登場	Elisabeta appears
エリザベータが仲間になった	Elisabeta joined
ルナが仲間になった	Luna joined
宝玉の間岩戸が開く	Open rock cave of Orb
精霊の使徒に勝利した	Victory over the Spirits Apostle
石板のメッセージを読んだ	Read the message on the Tablet
橋を動かすスイッチ	Switch to move the bridge
聖剣を入手した	Got the Sword
滝の下入口に入った	Entered the lower entrance of the waterfall
教会に行く	Go to church
光を発する	Emit light
集中線ON	Concentrated line ON
岩戸が爆発	Rock explodes
パワフルきのこを取った	Took the powerful mushroom
右から通過した	Passed from the right
聖剣入手イベント開始	Sword Acquisition Event begins
初めて最後の橋に来た	Came to the last bridge for the first time
ベムス出現	Bemus Appearance
祠の岩戸_光る精霊石	The rock door of the shrine_Glowing spirit stone
祠の岩戸_結界が解けた	The rock door of the shrine_The ward was removed
サイラス宝珠のお願い	Cyrus asks for Orb
砂漠最初に入った時	When they first entered the desert
サイラスセリフフェードアウト	Cyrus dialogue fades out
スイッチを踏んだ	Stepped on the switch
主人公に話かける	Talk to the main cast
商人ベムス用イベントスイッチ	Event Switch for Merchant Bemus
商人べムス主人公と接触	Contact with Merchant Bemus
商人べムスイベント終了	Merchant Bemus event ends
鳥が飛ぶ	The bird flies
鳥と接触した	Contact with the bird
商人べムスイベント別れた後	Merchant Bemus Event: After parting
宝玉を消す	Remove the Orb
エンディング	Ending
小鳥に触れた	Touching a little bird
ベムスHP	Bemus HP
イザベラがキッチンについた	Isabella's in the kitchen
ネイテイ村基本	Neitei Village Basic
キッチンに移動	Move to the kitchen
謎が解けた後	After the mystery is solved
小鳥が飛ぶ	A little bird flies
小鳥が飛ぶ_1	A little bird flies_1
小鳥が飛ぶ_2	A little bird flies_2
小鳥が飛ぶ_3	A little bird flies_3
小鳥が飛ぶ_4	A little bird flies_4
小鳥が飛ぶ_5	A little bird flies_5
空を飛ぶ_振動	Flying_Vibration
ルナが仲間になる	Luna joined
サイラス先生のところに行かなきゃ！	I have to get to Mr. Cyrus!
サイラス先生に剣を見せに行かないと！	I have to go show Mr. Cyrus my sword!
サイラス先生に剣を見せにいかないと！	I have to go show Mr. Cyrus my sword!
サイラス先生に剣を見せにいかなきゃ！	I have to go show Mr. Cyrus my sword!
私はエリザベータ\!\n大地の宝珠のところまで一緒に行ってやるよ	I'm Elisabeta. I'll go with you to the Earth Orb.
X座標	X Coordinate
Z座標	Z Coordinate
狼に触れた	Touching the wolf
宝珠の間岩戸前	In front of the Rock Door of the Orb Room
岩戸シートに移動	Move to the Rock Door Sheet
先に進もう	Let's move on
黒帯	Letterboxing
おじいさんに話しかけた	Talked to the old man
祠の結界が解けた	Shrine's warding has been lifted	
橋が上がった	The bridge is up
上昇した	Moved up
炎の精霊石を入手した	Got the Spirit Stone of Flame
入口から来た	Came in through the entrance
カメラ切り替え階段上	Camera switch on stairs
パーティーメンバー表示	Display Party Members
\iこの先危険	\iDanger Ahead
ここはセーブポイント	This is a save point.
男はそれ以降何もしゃべってくれない…	The man never spoke again...
サイラス神父にベムスのことを伝えないと！	We have to tell Mr. Cyrus about Bemus!
ベムスに負けた	Lost to Bemus
石板発見	Found the tablet
岩戸が消えた	Rock door's gone
岩戸爆発演出終了	End of rock door explosion
エンディング指定位置についた	Ending: at designated location
{0}は状態7になった！	{0} is now in state 7!
{0}は状態8になった！	{0} is now in state 8!
{0}は状態7から回復した！	{0} has recovered from state 7!
{0}は状態8から回復した！	{0} has recovered from state 8!
進化中	Evolving
進化成功演出中	Evolutionary Success Stage
進化キャンセル演出中	Evolution Cancellation Stage
進化成功演出完了	Evolutionary Success Stage ends
進化キャンセル演出完了	Evolution Cancellation Stage ends
ネムの滝	Nem Falls
灼熱の洞窟	Scorching Cave
砂漠	Desert
最後の橋	The Last Bridge
宝珠の祠	The Shrine of the Orb
ベムス商店	Bemus Shop
宝玉を取得後	After obtaining the Orb
聖堂夕方	Church Evening
ネイテイ村夕方	Neitei Village Evening
旧ネイテイ村_Ending	Old Neiteii Village_Ending
花火を見る	Watching fireworks
アングルを戻す	Restore the angle
女神の像	Statue of Goddess
聖剣の台座	Pedestal of the Sword
滝の下	Under the waterfall
台座の下	Under the pedestal
スタート	Start
デフォルト	Default
教会までの道のり	Road to the church
橋の上-入口	On the bridge - entrance
デフォ	Default
話かける	speak to
オープニング	Opening
初期位置	Initial Position
暗転	Theatrical Blackout
基本	Basic
スタート２	Start 2
スタート３	Start 3
橋の上-中腹	On the bridge - midway
橋の上-出口	On the bridge - exit
中腹-帰り	Midway - Return
出口-帰り	Exit - Return
砂漠_斜め上	Desert_Diagonally_up
砂漠標準	Desert Standard
デフォルト_side	Default_side
砂漠基本	Desert Basic
祠の扉	Door of the shrine
祠の扉開く	Open the door of the shrine
鍵光る	Twinkling Key
入口	Entrance
階段	Stairs
階段上	Stairs top
岩戸の前	Front of the rock door
宝珠の間	Orb Room
初めて最後の橋にきた	First time on the last bridge
光	Light
妖精の光	Fairy Light
3Dモデルモンスター	3D Model Monsters
2Dドットキャラクター	2D Dot Characters
建物パーツ	Building Parts
イベント専用スタンプ	For Events
2Dドットモンスター	2D Dot Monsters
教会_Endhing	Church_Ending
キャスト名	Cast Name
キャスト1経験値	Cast 1 EXP
キャスト2経験値	Cast 2 EXP
キャスト3経験値	Cast 3 EXP
キャスト4経験値	Cast 4 EXP
パーティキャスト表示	Party Cast Window
控えキャスト表示	Reserve Cast Window
パーティー表示	Party Window
対象キャスト	Target Cast
キャスト	Cast
選択キャスト名	Selected Cast Name
宝珠アップ	Close up of Orb
宝珠ゲット	Got Orb
ベムス登場	Bemus appears
エンディング_1	Ending_1
エンディング_2	Ending_2
ベムスを倒した	Bemus is down
ベムス登場寄り	Bemus appearance: close
橋が上がる	Bridge rising
zoomテスト	zoom test
ネイテイ村_夕	Neitei Village_Evening
教会	Church
最後の橋	The Last Bridge
カスタム_0	Custom_0
カスタム_1	Custom_1
カスタム_2	Custom_2
カスタム_3	Custom_3
カスタム_4	Custom_4
カスタム_5	Custom_5
カスタム_6	Custom_6
カスタム_7	Custom_7
カスタム_8	Custom_8
カスタム_9	Custom_9
カスタム_10	Custom_10
カスタム_11	Custom_11
カスタム_12	Custom_12
カスタム_13	Custom_13
カスタム_14	Custom_14
カスタム_15	Custom_15
カスタム_16	Custom_16
カスタム_17	Custom_17
カスタム_18	Custom_18
カスタム_19	Custom_19
カスタム_20	Custom_20
戦う	Fight
エリザベータバトルOP	Elisabeta Battle OP
イベントシート	Event Sheet
最後のバトル_ドラゴンに変身	Last battle_Transform into a dragon
夢の中	in a dream
イザベラ	Isabella
最初の会話	First conversation
2回目以降の会話	Conversation after the second time
左右移動	Left/right movement
村への出入り口	Entrance to the village
村への移動	Moving to the village
村への移動(２回め以降）	Moving to the village (after the second time)
イザベラ移動スイッチ	Isabella Move Switch
イザベラ移動開始	Isabella: start moving
家に戻ってきた時	When came back to the house
話しかけた時イザベラとの会話	Conversation with Isabella when talking to her
精霊の剣を入手する	Get the Spirit Sword
通常時	Usual
聖剣入手イベント開始	Sword Obtaining Event Begins
精霊の剣入手前	Before obtaining the Spirit Sword
精霊の剣を入手した	Got the sword
精霊の剣入手後	After obtaining the sword
精霊の剣の場所	Location of the sword
ネイテイ村への出口	Exit to Neitei Village
ネイテイ村へ移動	Move to Neitei Village
使徒との戦闘	Battle with the Apostle
擬音演出	onomatopoe
精霊の使徒に勝利した	Victory over the Apostle of the Spirits
使徒勝利後	After the Victory of the Apostle
入口_1	Entrance_1
入口_2	Entrance_2
入口_3	Entrance_3
入口_4	Entrance_4
入口_5	Entrance_5
入口_6	Entrance_6
入口_7	Entrance_7
階段_1	Stairs_1
階段_2	Stairs_2
階段_3	Stairs_3
精霊の剣を入手するスイッチ	Switch to get the sword.
精霊の剣イベントスイッチ	Sword Event Switch
砂漠との出入口	Gateway to the Desert
場所移動	Relocation
最後の橋との出入口	Gateway to the last bridge
場所移動_2回目以降	Relocation_2nd time onwards
Y軸移動ブロック	Y-axis moving block
ブロック移動	Block movement
中央_1	Center_1
中央_2	Center_2
中央_3	Center_3
中央_4	Center_4
中央_5	Center_5
宝箱-アイテムを得る(炎の精霊石)	Treasure Chest - Get Item (Spirit Stone of Flame)
手に入れる前	Before obtaining it
手に入れた後	After obtaining it
Z軸移動ブロック	Z-axis moving block
石版を読む	Read the tablet
石版を再度読む	Read the tablet again
橋を動かすスイッチ	Switch to move the bridge
オフ→オン	Off -> On
オン	On
溶岩から出てくる橋	Bridge coming out of the lava
溶岩から出てくる橋_2	Bridge coming out of the lava_2
橋を動かすスイッチへ移動ブロック	To the switch that moves the bridge: moving blocks
カギ未取得	Key not obtained
橋を動かすスイッチ	Switch to move the bridge
上昇した	Moved up
上昇	Move Up
炎の精霊石入手後	After obtaining the Spirit Stone of Flame
下降	Move Down
中央_6	Center_6
中央_7	Center_7
宝箱-重要なアイテムを得る(古代のカギ)	Treasure Chest - Obtain an important item (Ancient Key)
イベント3	Event 3
聖堂のドア	Church Door
案内板_1	Information board_1
案内板_イベント用	Information board_for event
ネムの滝への出入り口	Entrance to the Nem Falls
ネムの滝へ	To Nem Falls
移動禁止	Disable Movement
移動禁止権取得後	After Disable Movement
移動禁止宝珠依頼後	After Requesting Orb and Disable Movement
案内板_2	Information board_2
村の西洞窟入口	Entrance to the west cave of the village
村の中央洞窟入口	Entrance to the central cave in the village
セーブポイント	Save Point
セーブポイントの説明	Explanation of save points
カメラ_家から初めて出たとき	Camera _ First time out of the house
寄り道禁止メッセージ	No Detour Message
寄り道禁止	No detouring
村人グレイ	Villager Gray
会話_1	Conversation_1
会話_2	Conversation_2
おじいさん	Old Man
おじいさんの悩み	Old man's problem
メモの内容	Contents of the memo
パワフルきのこを取った	Took a powerful mushroom
空を飛ぶ	Fly in the air
商人ベムス	Bemus the merchant
商人べムス登場	Bemus the merchant appears
商人ベムス用イベントスイッチ	Event Switch for Merchant Bemus
商人べムス主人公へ近づく	Bemus the merchant: Approaching the main cast
商人べムス主人公と接触	Bemus the merchant: Contact the main cast
商人べムス会話	Merchant Bemus conversation
商人べムスイベント終了	Merchant Bemus event ends
商人べムス別れ	Merchant Bemus parting
商人べムスイベント別れた後	Bemus the merchant: After parting
商人べムス別れた後会話	Bemus the merchant: Conversation after parting
洞窟の番人	The Cave Keeper
ルナイベント用スイッチ	Switch for Lunar Event
ルナイベントスイッチ	Lunar Event Switch
ルナ登場	Luna appeared
主人公に近づく	Approaching the main cast
ルナと話す	Talking to Luna
ベムス用イベントスイッチ	Event Switch for Bemus
ベムスイベントスイッチ	Event Switch for Bemus
キノコイベント用エフェクト	Effect for mushroom event
パワフルきのこを取った	Took a powerful mushroom
パワフルきのこ取得前	Before obtaining Powerful Mushroom
パワフルきのこ取得後	After obtaining Powerful Mushroom
ケンの家に移動	Move to Ken's house
歩く犬	Walking Dog
おすわり	Sit
砂漠への門	Gate to the Desert
サイラスの話を聞いたあと	After listening to Cyrus
サイラスの話を聞く前	Before listening to Cyrus
剣取得後サイラスの話を聞く前	After getting the sword, before listening to Cyrus
砂漠へ移動初回	First time to the desert
砂漠へ移動	Move to the desert
灼熱の洞窟への出入口	Entrance to the Scorching Cave
灼熱の洞窟への出入り口	Entrance to the Scorching Cave
隠しダンジョンへの出入口	Entrance to the hidden dungeon
ネイテイ村への出入り口	Entrance to the Neitei Village
案内板_別ルートイベント作成用	Information board_for creating another route event
隠しイベント	Hidden Event
カメラ_砂漠に初めて入った	Camera_First time in the desert
エリザベータ登場イベント用スイッチ	Switch for Elisabeta appearance event
エリザベータ登場イベントオン	Elisabeta appearance event on
宝珠の祠への出入り口	Entrance to the Shrine of the Orb
右側_1	Right_Side_1
左側_1	Left_Side_1
右側_2	Right_Side_2
左側_2	Left_Side_2
カメラ_橋の中腹	Camera _ Middle of the bridge
カメラ_帰り	Camera_Return
祠の岩戸を発見	Found the rock door of the shrine
カメラ_橋の上出口	Camera _ Exit on the bridge
祠の岩戸	The rock door of the shrine
祠の岩戸が爆発	The rock door of the shrine explodes
爆発エフェクト	Explosion Effect
岩戸爆発演出	Rock door explosion
精霊石が光りだす	The spirit stone starts to glow
光る精霊石	Glowing Spirit Stone
イベント削除	Delete Event
カメラ_初めて最後の橋に来た	Camera _ First time on the last bridge
最後の橋への出入り口	The doorway to the last bridge
大地の宝珠	The Earth Orb
最後の闘い	The Last Battle
カメラ_階段	Camera_stairs
カメラ_入口	Camera_entrance
カメラ_階段上	Camera_on the stairs
宝珠の間岩戸発見	Room of the Orb: Discovering the rock door
宝珠の間岩戸前	Room of the Orb: in front of the rock door
岩戸を発見	Discovering the rock door
宝珠の間岩戸	Room of the Orb: The rock door
宝玉の間岩戸が開く	Room of the Orb: Opening the rock door
岩戸が開く	Opening the rock door
宝珠を取ってこい	Go get the Orb
宝珠の場所	Location of the Orb
宝珠取得後	After obtaining the Orb
聖堂入口	Entrance to the Church
洞窟の入り口	Entrance of the Cave
グレイ	Gray
カメラ_宝珠の間	Camera_Orb Room
押せる石像	Pushable stone statue
押せる石	Pushable Stone
押して転がせる	Push and roll
石像移動先	Stone statue destination
移動先	Destination
岩戸シートに移動	Move to the rock door sheet
岩戸シート	The rock door sheet
岩戸が開くスイッチオン	Switch on to open the rock door
立っている	Standing
バトルに負けた後	After losing a battle
村への出口	Exit to the village
商人べムスイベント終了	Merchant Bemus event ends
お店	Shop
購入後	After purchase
祭壇	Altar
サイラスからの手紙	Letter from Cyrus
夕方の聖堂	Evening Church
イベント31	Event 31
ベムス商店休業	Bemus Shop closed
セーブファイル	Save File
ベムスショップ	Bemus Shop
剣を抜く	Pull the Sword
剣を手に入れた	Got the Sword
剣を抜く２	Pull the Sword 2
最後のイベント	Last Event
逃げる村人	Running Away Villager
逃げる村人_2	Running Away Villager_2
逃げる村人_3	Running Away Villager_3
逃げる村人_4	Running Away Villager_4
逃げる村人_5	Running Away Villager_5
逃げる村人_6	Running Away Villager_6
逃げる村人_7	Running Away Villager_7
イベント1	Event 1
イベント2	Event 2
イベント3	Event 3
イベント4	Event 4
イベント5	Event 5
イベント6	Event 6
イベント7	Event 7
イベント8	Event 8
イベント9	Event 9
イベント10	Event 10
シート	Sheet
サイラスに報告しなくてはならない	Must report to Cyrus
サイラス先生	Cyrus
精霊の剣を取りに行くことを頼まれる	Asking to get the Sword of the Spirit
滝の場所	Waterfall Location
看板-メッセージ	Sign - Message
From オープニング/夢の中	From Opening / In a dream
From ケンの家/イザベラ	From Ken's House/Isabella
From Home/イベント12	From Home/Event 12
From Wetland/聖剣を入手する。	From Wetland/Get the Sword
From Wetland/イベント5	From Wetland/Event 5
\NPL[ルナ]\lipspd[0.6]あの壁のところに何かあるよ！	\NPL[Luna]\lipspd[0.6]There's something in that wall!
ここは転職のほこら	This is the place where you can change classes.
きっと　よい出会いがあるであろう	you'll have a good encounter.
\NPL[ルナ]早く宝珠を取りに行かないとダメだよ。	\NPL[Luna]We have to go get the Orb quickly.
セーブポイントの説明	Explanation of Save Points
From 砂漠_修正/Cave Entrance - Link to Another Place
エリザベータと話す	Talk to Elisabeta
\NPL[???]こっちのルートのイベントも作ってみなさい。	\NPL[???]You should also create events for this route.
From 砂漠_修正/エリザベータ	From desert_Mod/Elisabeta
From 最後の橋_修正/Event 2_3_3	From The Last Bridge_Mod/Event 2_3_3
From 宝珠の祠/最後の闘い	From Shrine of Orb/ The Last Battle
From 砂漠_修正/Cave Entrance - Link to Another Place	From desert_Mod/Cave Entrance - Link to Another Place
From 宝珠の祠_修正/イベント16	From Shrine of the Orb_Mod/Event 16
\NPR[ルナ]\lipspd[0.6]…\wどういうこと、これ…？	\NPR[Luna]\lipspd[0.6]....\wWhat is going on?
教会_Ending	Church/Ending
ネイテイ村_Ending	Neitei Village_Ending
From 教会_Ending/Mail_fromTeacher_2	From Church_Ending/Mail_fromTeacher_2
From ネイテイ村_修正/商人ベムス通せんぼ	From Neitei Village_Mod/Merchant Bemus Roadblock
From ネイテイ村_Ending_2/イベント5	From Neitei Village_Ending_2/event 5
From ネイテイ村_Ending_2/走り出す_4_2	From Neitei Village_Ending_2/running_4_2
From ネイテイ村_修正/イベント12	From Neitei Village_Mod/Event 12
\NPL[???]……まだ早い。	\NPL[???]...... still early.
岩・石	Rocks/Stones
2Dドットキャラクター	2D Dot Casts
神官（女）	Priest (Female)
植物	Plants
建物	Buildings
遺跡	Ruins
室内モデル	Indoor Models
OLD_武器	Old_Weapons
水	Water
勇者	Hero
建物_2	Buildings_2
遠景	Skybox
データ検証用	For data validation
マンガエフェクト	Manga Effect
データ検証用_2	For data validation_2
マンガエフェクト_2	Manga Effect_2
会話用	For conversation
メニュー関連画像	Menu related images
イベント専用画像	Event images
会話用スプライト	Conversation Sprites
2Dモンスター	2D Monsters
姫	Princess
サンプルゲーム用イメージ	Images for sample games
王様	King
ガイコツ	Skeleton
商人（荷持なし）	Merchant (without baggage)
商人（荷物あり）	Merchant (with baggage)
メイド	Maid
女王	Queen
王子	Prince
宝玉	Orb
モンスター（歩行）	Monsters (walking)
屋内	Indoor
屋外	Outdoor
仕掛け	Traps
狼	Wolf
おじさん	Old Man
未翻訳	untranslated
2Dアイコン	2D Icons
おばさん	Old Lady
女の子	Girl
足音	Footsteps (sound)
出入り口	Exit and Entrance
マッププレビュー	Map Preview
旧マップ	Old Maps
枠線	Grid-line
スキルテキスト 	Skill Text 
消費MPテキスト 	MP Consumption Text 
スキル、消費MP	Skills, MP Consumption
テキスト	Text
テキスト 	Text
テキスト	Text
ヘルプ	Help
キャラクター表示用_1	Display Cast_1
キャラクター表示用_2	Display Cast_2
選択スキル説明文	Selected Skill Descriptions
スキル6	Skill 6
スキル7	Skill 7
スキル8	Skill 8
スキル9	Skill 9
スキル10	Skill 10
スキル11	Skill 11
スキル12	Skill 12
スキル13	Skill 13
スキル14	Skill 14
スキル15	Skill 15
スキル22	Skill 22
スキル選択	Skill Selection
アイテム7	Item 7
アイテム8	Item 8
アイテム9	Item 9
アイテム10	Item 10
アイテム11	Item 11
アイテム12	Item 12
アイテム13	Item 13
アイテム20	Item 20
アイテム21	Item 21
アイテム22	Item 22
アイテム選択	Item Selection
あと	Until the Next Level
経験値あと	Until Next Level Up
レベルテキスト 	Level Text
アイテムテキスト 	Item Text
レベルアップ!	Level Up!
HPバー	HP Bar
MPバー	MP Bar
パーティ4	Party 4
パーティ3	Party 3
パーティ2	Party 2
パーティ1	Party 1
パーティー Party
全体背景	Overall Background
ゲーム終わる	Exit Game
メインメニュー	Main Menu
情報	Information
パーティー表示 Party Window
アイテム対象者選択	Item Target Selection
スキル使用者選択	Skill User Selection
スキル対象者選択	Skill Target Selection
装備変更者選択	Equipment Changer Selection
選択キャラクター名	Selected Cast Name
装備品	Equipments
パラメータ	Parameters
最大HP	Max HP
パラメータ名	Parameter Name
パラメータ値	Parameter Value
最大MP	Max MP
物理攻撃力	PHYS ATK
力	Strength
命中	Hit
回避	Evasion
装備アイコン	Equipment Icon
装備剣	Equipped Sword
装備盾	Equipped Shield
装備兜	Equipped Headgear
装備胴	Equipped Armor
装備アクセサリー1	Equipped Accessory 1
装備アクセサリー2	Equipped Accessory 2
装備部位選択	Equipment Parts Selection
装備選択	Equipment Selection
アイテム14	Item 14
アイテム15	Item 15
アイテム16	Item 16
パーティメンバー	Party Members
パーティ選択	Party Selection
控えメンバー	Reserve Members
控え選択	Reserve Selection
図鑑6	Picture Book 6
図鑑7	Picture Book 7
図鑑8	Picture Book 8
図鑑9	Picture Book 9
図鑑10	Picture Book 10
図鑑11	Picture Book 11
図鑑12	Picture Book 12
図鑑13	Picture Book 13
図鑑14	Picture Book 14
図鑑15	Picture Book 15
図鑑16	Picture Book 16
図鑑選択	Picture Book Selection
スキル0	Skill 0
ドロップアイテム	Drop Item
ドロップアイテム1	Drop Item 1
ドロップアイテム2	Drop Item 2
ドロップアイテム3	Drop Item 3
ドロップアイテム4	Drop Item 4
生息地	Habitat
生息地1	Habitat 1
生息地2	Habitat 2
生息地3	Habitat 3
生息地4	Habitat 4
詳細	Details
図鑑詳細	Picture Book Details
マップ下地	Base Map
プレイヤーアイコン	Player Icon
現在地	Current Location
現在地テキスト	Current Location Text
ファイル選択	File Selection
セーブデータ6	Save Data 6
セーブデータ7	Save Data 7
セーブデータ8	Save Data 8
セーブデータ9	Save Data 9
セーブデータ10	Save Data 10
セーブデータ11	Save Data 11
セーブデータ12	Save Data 12
セーブデータ13	Save Data 13
セーブデータ14	Save Data 14
セーブデータ15	Save Data 15
セーブデータ16	Save Data 16
セーブデータ17	Save Data 17
セーブデータ18	Save Data 18
セーブデータ19	Save Data 19
セーブ選択	Save Selection
セーブ情報表示	Save Information Window
下地	Base
セーブデータを上書きしますか?	Do you want to overwrite the saved data?
する	Yes
しない	No
操作	Operation
ガイド矢印	Guide Arrows
サウンド	Sound
設定の初期化	Initialize Settings
ゲーム終了確認表示	Game End Confirmation Window
枠	Frame
アイテム_1	Item_1
アイテム_2	Item_2
アイテム_3	Item_3
アイテム_4	Item_4
アイテム_5	Item_5
アイテム_6	Item_6
アイテム_7	Item_7
アイテム_8	Item_8
アイテム_9	Item_9
アイテム_10	Item_10
アイテム_11	Item_11
支払額	Amount Paid
所持アイテム	Items Possessed
状態 : \reservecondition	State: \reservecondition
状態 : \partycondition	State: \partycondition
状態 : \currentsavepartycondition[0]	State: \currentsavepartycondition[0]
状態 : \currentsavepartycondition[1]	State: \currentsavepartycondition[1]
状態 : \currentsavepartycondition[2]	State: \currentsavepartycondition[2]
状態 : \currentsavepartycondition[3]	State: \currentsavepartycondition[3]
消費HP : \currentlearnskillconsumptionhp		HP Consumption: \currentlearnskillconsumptionhp
消費MP : \currentlearnskillconsumptionmp	MP Consumption: \currentlearnskillconsumptionmp
消費HP : \selectskillconsumptionhp	HP Consumption: \selectskillconsumptionhp
消費MP : \selectskillconsumptionmp	MP Consumption: \selectskillconsumptionmp
種別 : \selecshoptitemcategory	Category : \selecshoptitemcategory
所持数 : \selectshopitemnum	Owned : \selectshopitemnum
泊まる : \innpriceG	Stay: \innpriceG
種別 : \selectitemcategory	Category : \selectitemcategory
この先灼熱の洞窟	"Lava Region Ahead"
剣の番人	Sword Keeper
買うアイテム選択	Items to be Purchased
売るアイテム選択	Items to be Sold
価格	Price
ページ	Page
左右でページ変更	<- Turn Pages ->
\NPR[ルナ]\lipspd[0.6]なによ、あなた誰？	\NPR[Luna]\lipspd[0.6]Hey, who are you?
\NPL[エリザベータ]\lipspd[0.6]私、エリザベータ。	\NPL[Elisabeta]\lipspd[0.6]I'm Elisabeta.
\NPL[???]\lipspd[0.6]悪いけどちょっと腕前を見せてもらうよ！\w[1]\^	\NPL[???]\lipspd[0.6]No offense, but I'm going to have to see how good you are!\w[1]\^
\NPL[エリザベータ]\lipspd[0.6]大地の宝珠のところまで一緒に行ってあげる\!\nよろしくね！	\NPL[Elisabeta]\lipspd[0.6]I'll go with you to the Earth Orb.\!\nMore the merrier, right?
\NPL[エリザベータ]\lipspd[0.6]まーまー、仲良くしましょ！	\NPL[Elisabeta]\lipspd[0.6]Well, well. Let's get along!
攻撃	Attack
防御	Guard
スキル	Skills
アイテム	Items
{0} は再び立ち上がった!	{0} stood up!
{0} は毒におかされている…	{0} is poisoned...
{0} の体から毒が消えた!	{0} recovered from poison!
{0} は眠っている…	{0} is sleeping...
{0} は目が覚めた!	{0} has woken up!
{0} は体がマヒして動けない!	{0} is paralyzed and can't move!
{0} はマヒが解けた!	{0} recovered paralysis!
{0} は混乱している…	{0} is confused...
{0} は正気に戻った!	{0} recovered from confusion!
{0} は惑わされている…	{0} is charmed...
{0} は我に返った!	{0} recovered from charm!
敵全体に雷属性のダメージを与える	Lightning damage to all enemies
敵単体に噛みついて毒を与える	Bites and poisons a single enemy
大地を揺るがし敵全体に大ダメージを与える	Shakes the earth and deals heavy damage to the entire enemy
敵全体に火属性のダメージを与える	Deals fire damage to all enemies
敵単体を魅了する	Charms a single enemy
\iみんなの体に力がみなぎった！	Everyone's status restored!
RPG Developer Bakinを使ってどのようなゲームを作ることができるのか、その一端を感じていただけるサンプルゲームです。\nテストプレイでゲームを遊んでいただいた上で、プロジェクト内でどんな設定をしているのかを見ていただくことでBakinでのゲーム作りの参考になるはずです。\n	This is a sample game that gives you an idea of what kind of games you can create using RPG Developer Bakin.\nAfter you have played the game in test play, it will be helpful for you to see what settings are specified in the project to assist in creating games in Bakin.
入口_戻り	Entrance_ Return
スタート２_3	Start2_3
スタート３_2	Start3_2
ケンHP監視	Ken HP Monitoring
レターボックス	Letterboxing
勇者A	Hero A
勇者B	Hero B
白魔導士	White Mage
白魔道士	White Mage
黒魔道士	Black Mage
神官A	Priest A
格闘家A	Warrior A
格闘家B	Warrior B
大魔導士	Grand Mage
エルフA	Elf A
エルフB	Elf B
村人A	Villager A
王族A	Royal A
ハウスキーパー	Housekeeper
王族B	Royal B
王族C	Royal C
王族D	Royal D
商人	Merchant
商人A	Merchant A
商人B	Merchant B
スライム	Slime
ゴブリン	Goblin
ガイコツ	Skeleton
狼	Wolf
小鳥	Bird
兵士	Soldier
大臣	Cabinet Minister
村人B	Villager B
男の子	Boy
船乗り	Sailor
黒魔術師	Black Magician
白魔術師	White Magician
神官B	Priest B
兵士（兜）	Soldier (Helmet)
村人A	Villager A
村人B	Villager B
村人C	Villager C
村人D	Villager D
村人E	Villager E
海賊	Pirate
店員A	Clerk A
店員B	Clerk B
子供A	Kid A
子供B	Kid B
賢者	Sage
隊長	Captain
執事	Butler
聖職者A	Clergyperson A
聖職者B	Clergyperson B
占い師	Fortuneteller
老人A	Senior Citizen A
犬	Dog
老人B	Senior Citizen B
酒場A	Bar A
酒場B	Bar B
悪魔の騎士	Demon Knight
chr001勇者A	chr001HeroA
chr002勇者B	chr002HeroB
chr003エルフA	chr003ElfA
chr004エルフB	chr004ElfB
chr005格闘家A	chr005WarriorA
chr006格闘家B	chr006WarriorB
chr007神官A	chr007PriestA
chr008神官B	chr008PriestB
chr009黒魔術師	chr009BlackMage
chr010白魔術師	chr010WhiteMage
chr011大魔道士	chr011GrandMage
chr012子供A	chr012ChildA
chr013子供B	chr013ChildB
chr014村人D	chr014VillagerD
chr015村人C	chr015VillagerC
chr016村人B	chr016VillagerB
chr017村人E	chr017VillagerE
chr018老人A	chr018OldPersonA
chr019老人B	chr019OldPersonB
chr020酒場A	chr020BarA
chr021酒場B	chr021BarB
chr022王族A	chr022RoyalA
chr023王族B	chr023RoyalB
chr024王族C	chr024RoyalC
chr025王族D	chr025RoyalD
chr026大臣	chr026CabinetMinister
chr027兵士1	chr027Soldier1
chr027兵士2	chr027Soldier2
chr028隊長	chr028Captain
chr029ハウスキーパー	chr029Housekeeper
chr030執事	chr030Butler
chr031賢者	chr031Sage
chr032占い師	chr032Fortuneteller
chr033聖職者A	chr033ClergypersonA
chr034聖職者B	chr034ClergypersonB
chr035海賊	chr035Pirate
chr036船乗り	chr036Sailor
chr037商人	chr037Merchant
橋を上がったままにする	Leave the bridge up
橋が下がる	The bridge is down
橋が上がる前	Before the bridge goes up
光るパネル_正解判定用	Glowing panel_for judging correct answers
押せる石イベントゴール	Pushable Stone Event Goal
キラキラ	Glitter
ルナ_エンディング	Luna_Ending
エリザベータ_エンディング	Elisabeta_Ending
From /最後のバトル_ドラゴンに変身	From /Last Battle_Turn into Dragon
From ???/夢の中	From ????? /In a dream
From ネイテイ村/砂漠への門	From Neitei Village/Gate to the Desert
From 砂漠/ネイテイ村への出入り口	From Entrance/exit to Desert/Neitei Village
イベントから下に向けてレイキャストを飛ばして、下にイベントの存在を検知したらゴールにカチっとはまるようにしたイベントです。	This is an event that sends a raycast downward from the event and clicks into the goal when the presence of the event is detected below.
レイキャストを出すイベント（押せる石）とこのイベントが重なってしまうと、このイベントの存在が検知されないため、地面に埋め込んでいます。	If this event overlaps with an event that produces a ray cast (a pushable stone), the presence of this event will not be detected, so it is embedded in the ground.
このゴールオブジェクトとの摩擦によって押せる石の移動が妨げられるのを防ぐため、あえてイベント化して衝突判定を全てオフにしています。\n	To prevent the movement of the pushable stone from being hindered by friction with this goal object, all collision detection is turned off by daring to make it an event.\n
効果音を3Dサウンドとして鳴らす場合、イベント開始条件は「1回だけ実行」を選んでください。	When sound effects are played as 3D sounds, select "Execute only once" for the event start condition.
まだ早い。	It's still early.
アイスソードを手に入れた！	Got the Ice Sword!
50Gを手に入れた！	Got 50G!
精霊の剣を護る番人。剣を求める者に闘いを挑み、剣を手にする資格があるかを試す。	A guardian of the sword of the spirit. He challenges those who seek the sword to a fight and tests whether they are qualified to hold the sword in their hands.
レイピア	Rapier
細身の剣	Slim sword
ショートボウ	Short Bow
扱いやすい狩猟用の小型弓	Easy-to-handle small bow for hunting
モーニングスター	Morning Star
メイスの一種\n威圧感は抜群である\nこんなもので叩いたら痛そう…	A type of mace\nIt is very intimidating.\nIt would hurt to be smacked with something like this...
槍	Spear
一般的な槍\n練度が低い者でも戦力になる	General Spear\nEven those with low skill levels can be useful in the battlefield.
{0} は毒におかされている….	{0} is poisoned ....
地形	Terrains
道	Road
Low_屋外	Low_Outdoor
遺跡飾り	Ruins Decoration
魔王城	Devil's Castle
Low_室内	Low_Indoor
Low_建物	Low_Building
イベント用スプライト	Event Sprites
レイアウト関連画像	Layout Related Images
イベント用	For Events
HD屋内	HD Indoor
遺跡パーツ	Ruins Parts
パーティクル	Particles
Low_植物	Low_Plants
3Dスタンプ化済み	3D stamped
ネムの滝-水面	Nem Falls - Water surface
レイアウト用スプライト	Layout Sprites
選択肢	Selection
選択肢左上	Top-Left
選択肢上	Top
選択肢右上	Top-Right
選択肢左	Left
選択肢中央	Center
選択肢右	Right
選択肢左下	Bottom-Left
選択肢下	Bottom
選択肢右下	Bottom-Right
選択肢テキスト	Text
文字入力上	Top
文字入力中央	Center
文字入力下	Bottom
入力文字表示	Output Window
入力文字	Output String
文字一覧表示	Input Window
文字一覧	Input String
ステータス一覧表示	Status List Window
装備キャラクター名前	Equipped Cast Name
選択キャラクター画像	Selected Cast Image
種別:\selecshoptitemcategory	Category: \selecshoptitemcategory
所持数:\selectshopitemnum	Owned: \selectshopitemnum
メッセージ用スプライト	Message Sprites
メッセージスプライト	Message Sprites
状態異常01	State Change01
状態異常02	State Change02
状態異常03	State Change03
状態異常04	State Change04
状態異常05	State Change05
ページ数	Pages
最大ページ数	Max Pages
ガイド	Guide
戦闘パラメータ	Battle Parameters
パラメータ増減値	Parameter Increment Values
生命力	Vitality
図鑑達成率	Picture Book Completion Rate
下線	Underline
セーブした日時	Saved Date and Time
購入数	Quantity
経験値ゲージ	EXP Gauge
裏板	Back Plate
キャスト名裏板	Cast name back plate
覚えたスキル	Learned Skills
スキル名前1	Skill Name 1
スキル名前2	Skill Name 2
スキル名前3	Skill Name 3
スキル名前4	Skill Name 4
パラメータ値変化前	Before Parameter Value Change
パラメータ成長	Parameter Growth
上昇ステータス1	Increased Status1
上昇ステータス2	Increased Status2
上昇ステータス3	Increased Status3
上昇ステータス4	Increased Status4
マップ名表示	Map Name Window
売却数	Quantity
サンプルタイトル	Sample Title
ステータス数値	Status Values
しかし{0}が足りなかった！	But there weren't enough {0}!
セーブデータ無し	No Save Data
パーティへ移動させる	Move to the Party
控えへ移動させる	Move to the Reserve
{0}が現れた！	{0} is emerging!
回避率アップ	Increase Evasion Rate
攻撃力アップ	Increase Attack Power
耐性ダウン	Reduce Resistance
瀕死	Less HP
{0} は回避率がアップした!	{0}'s evasion rate increased!
{0} の回避率が元に戻った	{0}'s evasion rate is back to normal.
{0} は攻撃力がアップした!	{0}'s attack power increased!
{0} の攻撃力が元に戻った	{0}'s attack power is back to normal.
{0} は全ての耐性がダウンした…	{0}'s all resistances are reduced...
{0} の全ての耐性が元に戻った!	{0}'s all resistances are back to normal.
EP1_WoodenFloor_01_通行不可	EP1_WoodenFloor_01_Non-Traversable
EP1_rock_01_通行不可	EP1_rock_01_Non-Traversable
EP1_magma_01_通行可能	EP1_magma_01_Traversable
EP1_PoisonSwanp_01_通行不可	EP1_PoisonSwanp_01_Non-Traversable
ベッド1	Bed1
ベッド2	Bed2
つぼ	Vase
ロウソクの火	Candle Flame
壁棚１セット	Wall shelf 1 set
壁棚１	Wall shelf 1
壁棚２セット	Wall shelf 2 set
壁棚２	Wall shelf 2
壁棚３セット	Wall shelf 3 set
壁棚３	Wall shelf 3
ランタン	Lantern
キャンドルスタンド-卓上	Candleholder-Tabletop
キャンドルスタンド-手持ち	Candleholder-Handheld
キャンドルスタンド-壁掛け	Candleholder-WallMounted
水草	WaterPlant
水連	WaterLily
蓮	Lotus
朽ち果てた寺院	Ruined Temple
マグマ	Magma
闇の炎	Flames of Darkness
雲	Cloud
煙突の煙	Chimney Smoke
火の粉	Sparks
岩破壊	Rock destruction
蛍の光	light of a firefly
蛍の光２	light of a firefly2
滝下	under the waterfall
滝下２	under the waterfall2
滝上	above the waterfall
滝上２	above the waterfall2
日差し	Sunlight
爆発	Explosion
光２	Light2
霧２	Fog2
鳥	Bird
霧	Fog
光るパネル	Glowing Panel
砂煙	Sand Cloud
水面の光	Light on the water
遺跡-宝玉-玉_光沢移動なし	Ruins-Orb-Orb_NoLusterMovement
遺跡-宝玉-玉	Ruins-Orb-Orb
遺跡-宝玉-台座	Ruins-Orb-Pedestal
夕方用空遠景	Evening Skybox
水面_2	WaterSurface_2
滝_2	Waterfall_2
滝-角_2	Waterfall-Corner_2
火球	Fireball
雨	Rain
雪	Snow
炎	Fire
煙	Smoke
嵐	Storm
雷	Thunder
紙ふぶき	Confetti
花火	Fireworks
霧	Fog
北風	Cold Wind
闇の炎	Dark Fire
焚き火	Small Fire
スパーク	Spark
宝箱-貴重品	Treasure Chest - Valuable Item
ブロック破壊	Block Destruction
湖面の光	Light on Lake
毒ガス	Poison Gas
火球_finish	Fireball_finish
出現B	Appearance B
登場(悪)	Appearance (Evil)
青色ボタン_old	BlueButton_old
緑色ボタン_old	GreenButton_old
赤色ボタン_old	RedButton_old
黄色ボタン_old	YellowButton_old
青色ボタン-PUSH	BlueButton-PUSH
赤色ボタン-PUSH	RedButton-PUSH
緑色ボタン-PUSH	GreenButton-PUSH
黄色ボタン-PUSH	YellowButton-PUSH
Water_ネムの滝	Water_NemFalls
ベムスイベント用	For Bemus Event
イベント用エフェクト	Event Effect
キノコイベント	Mushroom Event
精霊の剣2D	Spirit Sword 2D
ゴゴゴ	Shaking
集中線	Concentration Line
集中線1	Concentration Line1
集中線2	Concentration Line2
背景_表示	Background_Display
背景出現	Background appearance
ロゴ_ 出現	Logo_ Appearance
ロゴ_表示	Logo_Display
選択中	Selecting
待機中	Waiting
消滅	Disappearance
出現	Appearance
表示中	Displaying
勇者A-精霊の剣取得用	HeroA-GettingSpritSword
勇者A精霊の剣取得演出用	HeroA_GettingSpritSword_forScene
勇者A精霊の剣取得用演出用	HeroA_forGettingSpritSword_forScene
勇者A精霊の剣取得用	HeroA_GettingSpritSword
メニューアニメ用	For menu animation
メニューカーソル	Menu Cursor
タイトルカーソル	Title Cursor
テキストカーソル	Text Cursor
テキストカーソル_黒	Text Cursor_Black
メッセージスプライト	Message Sprite
マップコレクション	Map Collection
カスタム_0	Custom_0
カスタム_1	Custom_1
カスタム_2	Custom_2
Tutorial(朝)_0	Tutorial(morning)_0
勇者	Hero
静止-話す	Stationary-Speak
シート	Sheet
イベントシート	Event Sheet
荷馬車	Cart
城門	Castle Gate
こんにちは。\nただ何となく、何かが起きるのを待っているんだ。	Hello. \I'm just waiting for something to happen.
広葉樹-デフォルメ	Broadleaf Tree-Deformation
格闘家	Fighter
ロウソクの火	Candle Flame
棚	Shelf
テーブル_2	Table_2
白い皿	White Plate
白い皿-オーバル	White Plate - Oval
白い皿-ラウンド	White Plate - Round
木の皿	Wooden Plate
木の皿-オーバル	Wooden Plate - Oval
木の皿-ラウンド	Wooden Plate - Round
銀の皿	Silver Plate
銀の皿-オーバル	Silver Plate - Oval
銀の皿-ラウンド	Silver Plate - Round
書類	Papers
地図	Map
巻物	Scroll
キャンドルスタンド-卓上	Candleholder - Tabletop
キャンドルスタンド-手持ち	Candleholder - Handheld
キャンドルスタンド-壁掛け	Candleholder - Wall Mounted
壁棚１セット	Wall Shelf 1 set
壁棚１	Wall Shelf 1
壁棚２セット	Wall Shelf 2 Set
壁棚２	Wall Shelf 2
壁棚３セット	Wall Shelf 3 Set
壁棚３	Wall Shelf 3
リュック	Backpack
マリンバッグ	Marine Bag
農具A	Agricultural Tool A
農具B	Agricultural Tool B
釣り竿	Fishing Rod
ランタン-点灯	Lantern-lit
ランタン	Lantern
ベッド1	Bed 1
ベッド2	Bed 2
牢屋_ベッド	Prison_bed
牢屋_檻_ドア無し	Prison_cage_no door
牢屋_手錠	Prison_handcuffs
牢屋_足錠	Prison_foot lock
花２B	Flower 2B
花２A	Flower 2A
ソファ	Sofa
ソファ-一人掛け用	Sofa-for one person
木の丸テーブル	Wooden Round Table
木の丸椅子	Wooden Round Chair
タンス１	Drawers 1
タンス２	Drawers 2
鉢植え１	Potted Plant 1
鉢植え１-鉢植え	Potted Plant 1-Potted plant
鉢植え２	Potted Plant 2
鉢植え２-鉢植え	Potted Plant 2-Potted plant
鉢植え_花		Potted Plant-Flower
植木鉢１	Flowerpot 1
植木鉢１-鉢植え	Flowerpot 1-Pot
植木鉢１-植木	Flowerpot 1-Tree
植木鉢２	Flowerpot 2
植木鉢２-鉢植え	Flowerpot 2-Pot
植木鉢２-植木	Flowerpot 2-Tree
絨毯	Carpet
絵画-女性	Painting -Woman
絵画-風景	Painting-Landscape
絵画-地図	Painting-Map
鍛冶場	Blacksmith
鍛冶場-水場	Blacksmith-Waterfield
鍛冶場-作業台	Blacksmith-Workbench
鍛冶場-ハンマー	Blacksmith-Hammer
鍛冶場-挟み	Blacksmith-Pinch
鍛冶場-ふいご	Blacksmith-Bellows
ピアノ	Piano
ピアノ椅子	Piano Chair
トロフィー金	Trophy-Gold
トロフィー銀	Trophy-Silver
トロフィー銅	Trophy-Bronze
トマト	Tomato
トマト_ザル	Tomato _ colander
トマト_箱	Tomato _ box
ニンジン	Carrot
ニンジン_ザル	Carrot _ colander
ニンジン_箱	Carrot _ box
ジャガイモ	Potato
ジャガイモ_ザル	Potato _ colander
ジャガイモ_箱	Potato _ box
ズッキーニ	Zucchini
ズッキーニ_ザル	Zucchini_Zaru
ズッキーニ_箱	Zucchini_box
ロッキングチェア	Rocking Chair
タペストリー１	Tapestry 1
タペストリー２	Tapestry 2
タペストリー３	Tapestry 3
リンゴ	Apple
パン	Bread
木のコップ	Wooden Cup
ワイングラス	Wine Glass
鉄のコップ	Iron Cup
酒瓶	Liquor Bottle
ワイン	Wine
マグカップ	Mug
ビールジョッキ	Beer Mug
ティーポット	Teapot
ポット	Pot
リクライニングチェア	Reclining Chair
タル	Barrel
敷き布	Mat cloth
木箱_2	Wooden Box_2
ノートパソコン	Laptop
ゴミ箱	Garbage Can
地球儀	Globe
みかん箱	Mandarin Orange Box
みかん	Mandarin Orange
招き猫	Beckoning Cat
城門	Castle Gate
城壁00	Castle Wall 00
城壁01	Castle Wall 01
城壁02	Castle Wall 02
城壁03	Castle Wall 04
城壁パーツ00A	Castle Wall Parts 00A
城壁パーツ00B	Castle Wall Parts 00B
城壁パーツ00C	Castle Wall Parts 00C
城壁パーツ01A	Castle Wall Parts 01A
城壁パーツ01B	Castle Wall Parts 01B
城壁パーツ01C	Castle Wall Parts 01C
城壁パーツ02A	Castle Wall Parts 02A
城壁パーツ02B	Castle Wall Parts 02B
城壁パーツ02C	Castle Wall Parts 02C
城壁パーツ03A	Castle Wall Parts 03A
城壁パーツ03B	Castle Wall Parts 03B
城壁パーツ03C	Castle Wall Parts 03C
お城パーツ-旗	Castle Parts-flag
お城パーツ-煙突	Castle Parts-chimney
お城パーツ-円形壁00	Castle Parts-Circular wall 00
お城パーツ-円形壁01	Castle Parts-Circular wall 01
お城パーツ-円形壁02	Castle Parts -Circular wall 02
お城パーツ-円形壁の屋根00	Castle Parts-Roof of circular walls 00
お城パーツ-円形壁の屋根01	Castle Parts-Roof with circular walls 01
お城パーツ-円形壁の屋根02	Castle Parts-Roof with circular walls 02
お城パーツ-先端00	Castle Parts-tip 00
お城パーツ-扉枠	Castle Parts-door frame
お城パーツ-窓00	Castle Parts-window 00
お城パーツ-窓01	Castle Parts-window 01
お城パーツ-壁01	Castle Parts-wall 01
お城パーツ-壁02	Castle Parts-wall 02
お城パーツ-壁03	Castle Parts-wall 03
お城パーツ-屋根	Castle Parts-roof
生垣A	Hedge A
生垣B	Hedge B
生垣C	Hedge C
生垣D	Hedge D
生垣‐赤A	Hedge-Red A
生垣‐赤B	Hedge-Red B
生垣‐赤C	Hedge-Red C
生垣‐赤D	Hedge-Red D
生垣‐白A	Hedge-White A
生垣‐白B	Hedge-White B
生垣‐白C	Hedge-White C
生垣‐白D	Hedge-White D
生垣‐ピンクA	Hedge-Pink A
生垣‐ピンクB	Hedge-Pink B
生垣‐ピンクC	Hedge-Pink C
生垣‐ピンクD	Hedge-Pink D
花１A	Flower 1A
花１B	Flower 1B
花１C	Flower 1C
花２A_2	Flower 2A_2
花２B_2	Flower 2B_2
花２C	Flower 2C
花３A	Flower 3A
花３B	Flower 3B
花３C	Flower 3C
草B	Grass B
草C	Grass C
枯草A	Dead grass A
枯草B	Dead grass B
枯草C	Dead grass C
金の像	Gold statue
財宝	treasure
宝玉	Jewel
宝玉-玉	Jewels-Balls
宝玉-台座	Jewel-Pedestal
キッチン	Kitchen
キッチンセット	Kitchen set
カップ	Cup
包丁	Kitchen Knife
まな板	Cutting Board
空きビン１	Empty Bottle 1
空きビン２	Empty Bottle 2
深鍋	Deep Pot
深鍋-料理	Deep Pot-cooking
鍋	Pot
フライパン	Frying Pan
金塊	Bullion
革袋	Leather Bag
広葉樹	Broadleaf Tree
広葉樹-紅葉	Broadleaf Tree-Autumn leaves
広葉樹-果実	Broadleaf Tree-Fruit
針葉樹	Needle-leaved Tree
針葉樹-枯れ	Needle-leaved Tree-withered
針葉樹-雪	Needle-leaved Tree-snow
熱帯樹A	Tropical Tree A
熱帯樹B	Tropical Tree B
ツルA	Vine A
ツルB	Vine B
ツルＣ　	Vine C
ツルD	Vine D
ツルE	Vine E
ツルF	Vine F
熱帯植物A	Tropical Plant A
熱帯植物B	Tropical Plant B
亜熱帯樹A	Subtropical Tree A
亜熱帯樹B	Subtropical Tree B
バナナの木	Banana Tree
バナナの木-実なし	Banana Tree-no fruit
小麦	Wheat
小麦-黄金	Wheat-golden
シダ植物１	Fern Plant 1
シダ植物２	Fern Plant 2
シダ植物３	Fern Plant 3
キノコ１	Mushroom 1
キノコ２	Mushroom 2
キノコ３	Mushroom 3
水草	Aquatic plants
水蓮	Water Lilly
蓮	Lotus
なにもない！	There is nothing!
牢屋セット	Prison Set
青色ボタン_old	BlueButton_old
緑色ボタン_old	GreenButton_old
赤色ボタン_old	RedButton_old
黄色ボタン_old	YellowButton_old
キャンドルスタンド-火	Candleholder-Fire
暖炉	Fireplace
暖炉-炎	Fireplace-Flame
武器ラック	Weapons Rack
武器ラック-武器あり	Weapons Rack Set
武器ラック-武器	Weapons Rack Weapon
鉄の剣	Iron Sword
武器壁掛け1	Weapon Wall Hanging 1
武器壁掛け2	Weapon Wall Hanging 2
はしご	Ladder
柱時計	Wall Clock
柱時計-針	Wall Clock Hand
本棚	Book Shelf
本棚01	Book Shelf 01
本棚02	Book Shelf 02
本01	Book 01
本02	Book 02
本03	Book 03
本04	Book 04
本05	Book 05
本06	Book 06
本07	Book 07
本08	Book 08
本09	Book 09
本10	Book 10
積まれた本01	Stacked Books 01
積まれた本02	Stacked Books 02
積まれた本03	Stacked Books 03
岩A	Rock A
岩B	Rock B
岩C	Rock C
岩D	Rock D
岩E	Rock E
岩F	Rock F
岩-雪A	Rock-Snow A
岩-コケ大E	Rock-Moss Large E
岩-コケ大D	Rock-Moss Large D
岩-コケ大C	Rock-Moss Large C
岩-コケ大B	Rock-Moss Large B
岩-コケ大A	Rock-Moss Large A
岩-コケF	Rock-Moss F
岩-コケE	Rock-Moss E
岩-コケD	Rock-Moss D
岩-コケC	Rock-Moss C
岩-コケB	Rock-Moss B
岩-コケA	Rock-Moss A
岩-雪F	Rock-Snow F
岩-雪E	Rock-Snow E
岩-雪D	Rock-Snow D
岩-雪C	Rock-Snow C
岩-雪B	Rock-Snow B
岩-コケ大F	Rock-Moss Large F
石A	Stone A
石B	Stone B
石C	Stone C
石D	Stone D
石E	Stone E
石F	Stone F
石-雪A	Stone-Snow A
石-雪B	Stone-Snow B
石-雪C	Stone-Snow C
石-雪D	Stone-Snow D
石-雪E	Stone-Snow E
石-雪F	Stone-Snow F
石-コケA	Stone-Moss A
石-コケB	Stone-Moss B
石-コケC	Stone-Moss C
石-コケD	Stone-Moss D
石-コケE	Stone-Moss E
石-コケF	Stone-Moss F
石-コケ大A	Stone-Moss Large A
石-コケ大B	Stone-Moss Large B
石-コケ大C	Stone-Moss Large C
石-コケ大D	Stone-Moss Large D
石-コケ大E	Stone-Moss Large E
石-コケ大F	Stone-Moss Large F
自然	Nature
岩	Rocks
石	Stones
地形01a	Terrain 01a
地形01b	Terrain 01b
地形01c	Terrain 01c
地形01d	Terrain 01d
大きな地形01	BigTerrain 01
地形02a	Terrain 02a
地形02b	Terrain 02b
地形02c	Terrain 02c
地形02d	Terrain 02d
大きな地形02	BigTerrain 02
木のテーブル	Wooden Table
地形	Terrains
遠景	Skybox
地形03a	Terrain 03a
地形03b	Terrain 03b
地形03c	Terrain 03c
地形03d	Terrain 03d
大きな地形03	BigTerrain 03
岩-氷	Rock-Ice
地形04a	Terrain 04a
地形04b	Terrain 04b
地形04c	Terrain 04c
地形04d	Terrain 04d
大きな地形04	BigTerrain 04
岩-火山A	Rock-VolcanoA
岩-火山F	Rock-VolcanoF
岩-火山B	Rock-VolcanoB
岩-火山C	Rock-VolcanoC
岩-火山D	Rock-VolcanoD
岩-火山E	Rock-VolcanoE
広葉樹	Broadleaf Trees
広葉樹-紅葉	Broadleaf Tree-Autumn leaves
広葉樹-果実	Broadleaf Tree-Fruit
針葉樹	Needle-leaved Trees
針葉樹-枯れ	Needle-leaved Tree-withered
針葉樹-雪	Needle-leaved Tree-snow
熱帯樹A	Tropical Tree A
熱帯樹B	Tropical Tree B
ツルA	Vine A
ツルB	Vine B
ツルＣ　	Vine C
ツルD	Vine D
ツルE	Vine E
ツルF	Vine F
熱帯植物A	Tropical Plant A
熱帯植物B	Tropical Plant B
亜熱帯樹A	Subtropical Tree A
亜熱帯樹B	Subtropical Tree B
バナナの木	Banana Tree
バナナの木-実なし	Banana Tree-no fruit
小麦	Wheat
小麦-黄金	Wheat-golden
シダ植物１	Fern Plant 1
シダ植物２	Fern Plant 2
シダ植物３	Fern Plant 3
キノコ１	Mushroom 1
キノコ２	Mushroom 2
キノコ３	Mushroom 3
水草	Aquatic plants
水蓮	Water Lilly
蓮	Lotus
自然	Nature
草	Grasses
水生植物	Aquatic Plants
シダ植物	Fern Plants
花	Flowers
キノコ	Mushrooms
熱帯植物	Tropical Plants
広葉樹-デフォルメ	Broadleaf Trees-Deformation
広葉樹-デフォルメ-果実	Broadleaf Trees-Deformation-Fruits
広葉樹-デフォルメ-紅葉	Broadleaf Trees-Deformation-Red Leaves
針葉樹‐デフォルメ	Needle-leaved Trees-Deformation
針葉樹-デフォルメ	Needle-leaved Trees-Deformation
針葉樹-デフォルメ_枯れ木	Needle-leaved Trees-Deformation_Dry Tree
針葉樹-デフォルメ_雪	Needle-leaved Trees-Deformation_Snow
花１A	Flower 1A
花１B	Flower 1B
花１C	Flower 1C
花２A	Flower 2A
花２B	Flower 2B
花２C	Flower 2C
花３A	Flower 3A
花３B	Flower 3B
花３C	Flower 3C
草A	Grass A
草B	Grass B
草C	Grass C
枯草A	Dead grass A
枯草B	Dead grass B
枯草C	Dead grass C
木	Tree
木_紅葉	Tree_Red Tree
木_雪	Tree_Snow
細めの木_紅葉	Thin Tree_Red leaves
細めの木_雪	Thin Tree_Snow
細めの木	Thin Tree
木１	Tree 1
木２	Tree 2
木３	Tree 3
枯れ木A	Dry Tree A
枯れ木B	Dry Tree B
サボテン1a	Cactus1a
サボテン2a	Cactus2a
サボテン3a	Cactus3a
サボテン1b	Cactus1b
サボテン2b	Cactus2b
サボテン3b	Cactus3b
サボテン	Cactus
ボスゴブリン	Boss Goblin
噴水-水	Fountain - Water
木の手すり-端	Wooden Railing-End
木の手すり-コーナー	Wooden Railing-Corner
木の手すり	Wooden Railing
石の手すり-端	Stone Railing-End
石の手すり-コーナー	Stone Railing-Corner
石の手すり	Stone Railing
階段-草01	Stairs-Grass 01
階段-草02	Stairs-Grass 02
階段-泥01	Stairs-Mud 01
道-草	Road-Grass
道-草-行き止まり	Road-Grass-Dead End
道-草-コーナー	Road-Grass-Corner
道-草-分かれ道	Road-Grass-Forked Road
道-草-十字路	Road-Grass-Crossroads
道-泥	Road-mud
道-泥-行き止まり	Road-Mud-Dead End
道-泥-コーナー	Road-Mud-Corner
道-泥-分かれ道	Road-Mud-Forked Road
道-泥-十字路	Road-Mud-Crossroads
窓枠01	Window Frame 01
窓の明かり01	Window Light 01
水瓶	Water Bottle
階段-遺跡01	Stairs-Ruins 01
ダンジョン入口	Dungeon Entrance
ダンジョン出口	Dungeon Exit
木箱２	Wooden Box 2
草-装飾-角	Grass-Decoration-Corner
草-装飾-側面	Grass-Decoration-Side
つるA	Vine A
つるB	Vine B
茂み-大	Bush-Large
茂み	Bush
お城	Castle
レンガの家-屋根B	Brick House-Roof B
木のゲート	Wooden Gate
見張り塔	watchtower
レンガの家-壁02	Brick House-Wall 02
備蓄食料	Stockpile Food
藁葺きの家-壁02	Thatched House-Wall 02
壁時計	Wall Clock
木の柵-コーナー	Wooden Fence-Corner
木の柵-端	Wooden Fence-End
木の柵	Wooden Fence
カウンターテーブル	Counter Table
カウンターテーブル-コーナー	Counter Table-Corner
カウンターテーブル-端	Counter Table-End
棺桶	Coffin
橋２-高	Bridge 2-High
橋２	Bridge 2
木のドア	Wooden Door
ドラゴンの像-L	Dragon Statue-L
ドラゴンの像-R	Dragon Statue-R
橋	Bridge
橋-高	Bridge-High
花-シンプルA	Flower-Simple A
花-シンプルB	Flower-Simple B
花-シンプルC	Flower-Simple C
柱	Pillar
ドア１	Door 1
ドア２	Door 2
立て看板	Standing Signboard
石畳み	Cobblestone
切り株	Stump
教会のドア	Church Door
瓦礫	Rubble
石の橋	Stone Bridge
石の橋-長	Stone Bridge-Long
剣立て	Sword Stand
王座	Throne
木の橋	Wooden Bridge
天球儀	Armillary Sphere
噴水-水	Fountain-Water
噴水	Fountain
お城-旗	Castle-Flag
お城-小	Castle-Small
風車小屋-小	Windmill-Small
風車小屋-大	Windmill-Large
レンガの家-A	Brick House-A
レンガの家-B	Brick House-B
レンガの家01	Brick House 01
置き看板-宿屋	Signboard-Inn
置き看板-道具屋	Signboard-Tool Shop
置き看板-武器屋	Signboard-Weapon Shop
置き看板-防具屋	Signboard-Armor Shop
置き看板-無地	Signboard-Plain
レンガの家-ドア	Brick House-Door
レンガの家-柱	Brick House-Pillar
レンガの家-壁03	Brick House-Wall 03
藁葺きの家-A	Thatched House-A
藁葺きの家-B	Thatched House-B
藁葺きの家-屋根B	Thatched House-Roof B
藁葺きの家-柱	Thatched House-Pillars
藁葺きの家-壁03	Thatched House-Wall 03
藁葺きの家01	Thatched House 01
木の家-A	Tree House-A
木の家-B	Tree House-B
木の家-屋根B	Tree House-Roof B
木の家-柱	Tree House-Pillar
木の家-壁02	Tree House-Wall 02
木の家-壁03	Tree House-Wall 03
木の家01	Tree House 01
木の柵A	Wooden Fence A
木の柵B	Wooden Fence B
木の柵C	Wooden Fence C
木の柵D	Wooden Fence D
木の柵E	Wooden Fence E
木の柵F	Wooden Fence F
木の柵G	Wooden Fence G
テーブル	Table
骸骨	Skeleton
石像	Stone Statue
石の棺	Stone Coffin
クリスタル	Crystal
街灯	Street Lamp
木箱１	Wooden Box 1
バルコニー01パーツ-b	Balcony 01 parts-b
バルコニー01パーツ-c	Balcony 01 parts-c
バルコニー02パーツ-b	Balcony 02 parts-b
バルコニー02パーツ-c	Balcony 02 parts-c
バルコニー01	Balcony 01
バルコニー02	Balcony 02
バルコニー01パーツ-a	Balcony 01 parts-a
バルコニー02パーツ-a	Balcony 02 parts-a
窓01	Window 01
窓02	Window 02
窓03	Window 03
窓04	Window 04
窓05	Window 05
窓06	Window 06
窓07	Window 07
窓08	Window 08
窓09	Window 09
窓10	Window 10
窓11	Window 11
レンガの家-屋根A	Brick House-Roof A
レンガの家-壁01	Brick House-Wall 01
レンガの家03	Brick House 03
藁葺きの家-ドア	Thatched House-Door
藁葺きの家-屋根A	Thatched House-Roof A
藁葺きの家-壁01	Thatched House-Wall 01
藁葺きの家03	Thatched House 03
木の家-ドア	Tree House-Door
木の家-屋根A	Tree House-Roof A
木の家-壁01	Tree House-Wall 01
木の家03	Tree House 03
レンガの家-パーツ	Brick House-Parts
藁葺きの家-パーツ	Thatched House-Parts
木の家-パーツ	Tree House-Parts
木の柵	Wooden Fence
植木鉢_サブグラフィック	Flowerpot_Subgraphic
バルコニー	Balconies
窓	Windows
食べ物	Food
家具	Furniture
小物	Small Goods
背景物	Background Objects
柵	Fences
ドア	Doors
岩・石・地形	Rocks-Stones-Terrains
猫A	Cat A
猫B	Cat B
兵士（兜無し）	Soldier (no helmet)
サポートキャスト	Support Casts
モンスターキャスト	Monster Casts
ヒーローキャスト	Hero Casts
2Dキャスト	2D Casts
スプライト用	For Sprites
レイアウト用	For Layouts
アクション用	For Actions
アクション用_2	For Actions_2
フキダシ素材	Speech Bubble Assets
フキダシ下地	Speech Bubble Base
フキダシ1	Speech Bubble  1
フキダシ2	Speech Bubble  2
フキダシ3	Speech Bubble  3
フキダシ4	Speech Bubble  4
フキダシ5	Speech Bubble  5
フキダシ6	Speech Bubble  6
影	Shadow
吹き出し型メッセージ	Speech Bubble Message
吹き出し矢印	Speech Bubble Arrow
  #3D\n壁01と隣り合わせに使用します。	  #3D\nUsed next to Wall 01.
  #3D\n壁02,壁03と隣り合わせに使用します。	  #3D\nUsed next to Wall 02 and Wall 03.
 #2D reservedフォルダにあるデフォルトキャストのデータと見た目上は同じですが、イメージデータは別になっています。このデータに改変を加えてもデフォルトキャストのデータに影響はありません。	 #2D It is visually identical to the default cast data in the reserved folder, but the image data is separate. Any modifications to this data will not affect the default cast data.
reservedフォルダにあるデフォルトキャストのデータと見た目上は同じですが、イメージデータは別になっています。このデータに改変を加えてもデフォルトキャストのデータに影響はありません。	It is visually identical to the default cast data in the reserved folder, but the image data is separate. Any modifications to this data will not affect the default cast data.
